"","protocol_id","protocol_name","ct_orderset","order_id","description","ct_dw30m","ct_order","prob_order","ct_dw30m_noorderset","ct_med_noorderset","rate_dw30m_orderset","rate_dw30m_noorderset","RR_dw30m","ct_nodw30m_orderset","ct_nodw30m_noorderset","RR_pvalue"
"1",522,"ED PNEUMONIA",423,"9487","CEFTRIAXONE 1 GRAM IV SOLR",3,4,0.00945626477541371,13,272,0.75,0.0477941176470588,15.6923076923077,1,259,1.01652852668246e-06
"2",522,"ED PNEUMONIA",423,"96559","PIPERACILLIN-TAZOBACTAM-DEXTRS 3.375 GRAM/50 ML IV PGBK",1,7,0.016548463356974,1067,10067,0.142857142857143,0.105989867885169,1.34783772928103,6,9000,0.999999999999992
"3",522,"ED PNEUMONIA",423,"96560","PIPERACILLIN-TAZOBACTAM-DEXTRS 4.5 GRAM/100 ML IV PGBK",1,68,0.160756501182033,290,2601,0.0147058823529412,0.111495578623606,0.131896551724138,67,2311,0.0197573814605168
"4",522,"ED PNEUMONIA",423,"115287","LEVOFLOXACIN IN D5W 500 MG/100 ML IV PGBK",6,14,0.033096926713948,156,1438,0.428571428571429,0.108484005563282,3.95054945054945,8,1282,0.0007817771890473
"5",522,"ED PNEUMONIA",423,"115288","LEVOFLOXACIN IN D5W 750 MG/150 ML IV PGBK",2,81,0.191489361702128,208,3699,0.0246913580246914,0.0562314138956475,0.439102564102564,79,3491,0.326737262386161
"6",522,"ED PNEUMONIA",423,"122689","ALBUTEROL SULFATE 2.5 MG/0.5 ML INH NEBU",1,5,0.0118203309692671,142,1409,0.2,0.100780695528744,1.98450704225352,4,1267,0.999999999999998
"7",522,"ED PNEUMONIA",423,"124216","VANCOMYCIN IN D5W 1 GRAM/200 ML IV PGBK",16,130,0.307328605200946,1951,16917,0.123076923076923,0.115327776792576,1.06719236683358,114,14966,0.890473267593354
"8",522,"ED PNEUMONIA",423,"520039","AZITHROMYCIN IVPB",3,48,0.113475177304965,127,2522,0.0625,0.0503568596352102,1.24114173228346,45,2395,0.961827304710995
"9",522,"ED PNEUMONIA",423,"540102","NS IV BOLUS",2,29,0.0685579196217494,2225,80957,0.0689655172413793,0.0274837259285794,2.50932196822937,27,78732,0.424926564469396
"10",522,"ED PNEUMONIA",423,"540967","PIPERACILLIN-TAZOBACTAM 4.5 GRAM/100 ML MINI-BAG PLUS",5,34,0.0803782505910166,135,2073,0.147058823529412,0.065123010130246,2.25816993464052,29,1938,0.119795551317201
"11",522,"ED PNEUMONIA",423,"541084","CEFEPIME 2 GRAM/100 ML MINI-BAG PLUS",5,39,0.0921985815602837,277,3459,0.128205128205128,0.0800809482509396,1.60094418217162,34,3182,0.42255456033726
"12",522,"ED PNEUMONIA",423,"541085","CEFTRIAXONE 1 GRAM/50 ML MINI-BAG PLUS",1,24,0.0567375886524823,411,7130,0.0416666666666667,0.0576437587657784,0.722830494728305,23,6719,0.999999999999745
"13",523,"ED AMI-STEMI PROTOCOL",203,"680","ASPIRIN 81 MG PO CHEW",6,32,0.157635467980296,357,11203,0.1875,0.031866464339909,5.88392857142857,26,10846,7.77346854982215e-06
"14",523,"ED AMI-STEMI PROTOCOL",203,"10176","HEPARIN (PORCINE) 1,000 UNIT/ML INJ SOLN",3,58,0.285714285714286,164,2898,0.0517241379310345,0.0565907522429262,0.914003364171573,55,2734,0.999999999999931
"15",523,"ED AMI-STEMI PROTOCOL",203,"15846","HEPARIN (PORCINE) IN 5 % DEX 25,000 UNIT/250 ML(100 UNIT/ML) IV SOLP",1,31,0.152709359605911,68,899,0.032258064516129,0.0756395995550612,0.426470588235294,30,831,0.577113320157024
"16",523,"ED AMI-STEMI PROTOCOL",203,"77545","ATORVASTATIN 40 MG PO TABS",1,1,0.00492610837438424,159,9613,1,0.0165401019452824,60.4591194968553,0,9454,0.000157731528933068
"17",523,"ED AMI-STEMI PROTOCOL",203,"90097","NITROGLYCERIN 0.4 MG/DOSE TL SPRY",1,1,0.00492610837438424,1,33,1,0.0303030303030303,33,0,32,0.0570148352207188
"18",523,"ED AMI-STEMI PROTOCOL",203,"203749","CLOPIDOGREL 75 MG PO TABS",1,17,0.083743842364532,40,500,0.0588235294117647,0.08,0.735294117647059,16,460,1
"19",523,"ED AMI-STEMI PROTOCOL",203,"208212","PRASUGREL 10 MG PO TABS",1,15,0.0738916256157636,24,451,0.0666666666666667,0.0532150776053215,1.25277777777778,14,427,0.999999999999999
"20",523,"ED AMI-STEMI PROTOCOL",203,"214201","TICAGRELOR 90 MG PO TABS",1,4,0.0197044334975369,23,361,0.25,0.0637119113573407,3.92391304347826,3,338,0.63071241331896
"21",524,"ED SHORTNESS OF BREATH",628,"250","ALBUTEROL SULFATE 2.5 MG /3 ML (0.083 %) INH NEBU",7,41,0.0652866242038217,106,3939,0.170731707317073,0.0269103833460269,6.3444546709618,34,3833,4.57330089358468e-07
"22",524,"ED SHORTNESS OF BREATH",628,"78668","IPRATROPIUM-ALBUTEROL 0.5 MG-3 MG(2.5 MG BASE)/3 ML INH NEBU",2,130,0.207006369426752,493,18456,0.0153846153846154,0.0267121803207629,0.575940084256514,128,17963,0.598869850205443
"23",524,"ED SHORTNESS OF BREATH",628,"209509","METHYLPREDNISOLONE SOD SUC(PF) 125 MG/2 ML INJ SOLR",1,53,0.0843949044585987,275,8000,0.0188679245283019,0.034375,0.548885077186964,52,7725,0.810540610602515
"24",524,"ED SHORTNESS OF BREATH",628,"520002","DEXAMETHASONE (CUSTOM DOSE) IVPB",5,8,0.0127388535031847,168,1360,0.625,0.123529411764706,5.05952380952381,3,1192,0.000198015923642377
"25",524,"ED SHORTNESS OF BREATH",628,"540102","NS IV BOLUS",1,34,0.054140127388535,2225,80957,0.0294117647058824,0.0274837259285794,1.07015201586252,33,78732,0.999999999997799
"26",525,"ED ABDOMINAL PAIN ",1002,"3844","IBUPROFEN 600 MG PO TABS",1,2,0.00199600798403194,98,3745,0.5,0.0261682242990654,19.1071428571429,1,3647,0.0486130032760359
"27",525,"ED ABDOMINAL PAIN ",1002,"82384","PANTOPRAZOLE 40 MG IV SOLR",2,2,0.00199600798403194,688,12925,1,0.0532301740812379,18.7863372093023,0,12237,1.16997135943892e-05
"28",525,"ED ABDOMINAL PAIN ",1002,"112586","HYDROMORPHONE 1 MG/ML INJ SYRG",8,136,0.135728542914172,1219,33427,0.0588235294117647,0.036467526251234,1.61303865270472,128,32208,0.247089678427697
"29",525,"ED ABDOMINAL PAIN ",1002,"198509","ONDANSETRON HCL (PF) 4 MG/2 ML INJ SOLN",2,229,0.228542914171657,705,36939,0.00873362445414847,0.0190855193697718,0.457604757038001,227,36234,0.36778953274521
"30",525,"ED ABDOMINAL PAIN ",1002,"540102","NS IV BOLUS",2,268,0.267465069860279,2225,80957,0.00746268656716418,0.0274837259285794,0.271531108502432,266,78732,0.0692980754713673
"31",525,"ED ABDOMINAL PAIN ",1002,"540141","GI COCKTAIL",1,10,0.00998003992015968,39,917,0.1,0.0425299890948746,2.35128205128205,9,878,0.914641606875305
"32",525,"ED ABDOMINAL PAIN ",1002,"540300","MORPHINE INJECTABLE SYRINGE",3,94,0.093812375249501,61,1002,0.0319148936170213,0.0608782435129741,0.524241367282874,91,941,0.360177192335494
"33",526,"ED GI BLEED ",377,"82384","PANTOPRAZOLE 40 MG IV SOLR",4,124,0.328912466843501,688,12925,0.032258064516129,0.0532301740812379,0.60601087771943,120,12237,0.40324632809615
"34",526,"ED GI BLEED ",377,"530014","PANTOPRAZOLE 0.8 MG/ML IV INFUSION",2,102,0.270557029177719,72,1751,0.0196078431372549,0.0411193603655054,0.476851851851852,100,1679,0.4130877929008
"35",526,"ED GI BLEED ",377,"540102","NS IV BOLUS",1,56,0.148541114058355,2225,80957,0.0178571428571429,0.0274837259285794,0.649735152487961,55,78732,0.974743155880719
"36",534,"ED CELLULITIS/ABSCESS",32,"9488","CEFTRIAXONE 2 GRAM IV SOLR",1,2,0.0625,23,339,0.5,0.0678466076696165,7.3695652173913,1,316,0.319245865298994
"37",536,"ED FEVER/NEUTROPENIA",237,"520046","VANCOMYCIN IVPB (CUSTOM DOSE)",5,23,0.0970464135021097,1808,23328,0.217391304347826,0.0775034293552812,2.80492497114275,18,21520,0.034349581581189
"38",536,"ED FEVER/NEUTROPENIA",237,"540102","NS IV BOLUS",1,66,0.278481012658228,2225,80957,0.0151515151515152,0.0274837259285794,0.551290432414028,65,78732,0.813435685574951
"39",536,"ED FEVER/NEUTROPENIA",237,"541084","CEFEPIME 2 GRAM/100 ML MINI-BAG PLUS",5,43,0.181434599156118,277,3459,0.116279069767442,0.0800809482509396,1.45201914196961,38,3182,0.558542641171762
"40",538,"ED SEPTIC SHOCK",26,"95725","CEFTRIAXONE 2 GRAM INJ SOLR",1,1,0.0384615384615385,31,319,1,0.0971786833855799,10.2903225806452,0,288,0.181738411507938
"41",538,"ED SEPTIC SHOCK",26,"541089","VANCOMYCIN 1 GRAM/100 ML CENTRAL LINE MINI-BAG PLUS",1,1,0.0384615384615385,112,785,1,0.142675159235669,7.00892857142857,0,673,0.309636054941106
"42",539,"ED SEPSIS PROTOCOL",864,"5018","METRONIDAZOLE IN NACL (ISO-OS) 500 MG/100 ML IV PGBK",1,5,0.00578703703703704,223,3847,0.2,0.0579672472056148,3.45022421524664,4,3624,0.689078870446924
"43",539,"ED SEPSIS PROTOCOL",864,"96560","PIPERACILLIN-TAZOBACTAM-DEXTRS 4.5 GRAM/100 ML IV PGBK",1,46,0.0532407407407407,290,2601,0.0217391304347826,0.111495578623606,0.194977511244378,45,2311,0.0907672691055761
"44",539,"ED SEPSIS PROTOCOL",864,"115288","LEVOFLOXACIN IN D5W 750 MG/150 ML IV PGBK",1,22,0.025462962962963,208,3699,0.0454545454545455,0.0562314138956475,0.808347902097902,21,3491,0.999999999999994
"45",539,"ED SEPSIS PROTOCOL",864,"124216","VANCOMYCIN IN D5W 1 GRAM/200 ML IV PGBK",6,39,0.0451388888888889,1951,16917,0.153846153846154,0.115327776792576,1.33399045854197,33,14966,0.61629915644815
"46",539,"ED SEPSIS PROTOCOL",864,"520039","AZITHROMYCIN IVPB",1,12,0.0138888888888889,127,2522,0.0833333333333333,0.0503568596352102,1.65485564304462,11,2395,0.999999999999999
"47",539,"ED SEPSIS PROTOCOL",864,"520058","CASPOFUNGIN 70 MG IVPB",1,1,0.00115740740740741,56,1656,1,0.0338164251207729,29.5714285714286,0,1600,0.0106046631275878
"48",539,"ED SEPSIS PROTOCOL",864,"540102","NS IV BOLUS",9,211,0.244212962962963,2225,80957,0.042654028436019,0.0274837259285794,1.55197401352575,202,78732,0.25657982421943
"49",539,"ED SEPSIS PROTOCOL",864,"540967","PIPERACILLIN-TAZOBACTAM 4.5 GRAM/100 ML MINI-BAG PLUS",5,47,0.0543981481481481,135,2073,0.106382978723404,0.065123010130246,1.63356973995272,42,1938,0.406931664366999
"50",539,"ED SEPSIS PROTOCOL",864,"541020","VANCOMYCIN ED ORDER ",12,77,0.0891203703703704,213,1807,0.155844155844156,0.117874930824571,1.3221145052131,65,1594,0.408360276740031
"51",539,"ED SEPSIS PROTOCOL",864,"541084","CEFEPIME 2 GRAM/100 ML MINI-BAG PLUS",2,16,0.0185185185185185,277,3459,0.125,0.0800809482509396,1.56092057761733,14,3182,0.842558049696187
"52",539,"ED SEPSIS PROTOCOL",864,"541085","CEFTRIAXONE 1 GRAM/50 ML MINI-BAG PLUS",2,9,0.0104166666666667,411,7130,0.222222222222222,0.0576437587657784,3.85509597188429,7,6719,0.161762888221869
"53",539,"ED SEPSIS PROTOCOL",864,"541086","CEFTRIAXONE 2 GRAM/50 ML MINI-BAG PLUS",3,10,0.0115740740740741,174,2732,0.3,0.0636896046852123,4.71034482758621,7,2558,0.0168089936072586
"54",539,"ED SEPSIS PROTOCOL",864,"541110","ERTAPENEM 1 GRAM/50 ML MINI-BAG PLUS",1,2,0.00231481481481481,72,1340,0.5,0.0537313432835821,9.30555555555556,1,1268,0.222234783408579
"55",539,"ED SEPSIS PROTOCOL",864,"541442","NS IV BOLUS - 2000 ML",6,32,0.037037037037037,5,120,0.1875,0.0416666666666667,4.5,26,115,0.0144814201647833
"56",539,"ED SEPSIS PROTOCOL",864,"541448","LR IV BOLUS - 30 ML/KG",2,8,0.00925925925925926,1,6,0.25,0.166666666666667,1.5,6,5,1
"57",540,"ED ALLERGIC REACTION",10,"213662","EPINEPHRINE 1 MG/ML (1:1,000) (1ML) INJ SOLN",1,5,0.5,69,5047,0.2,0.0136714880126808,14.6289855072464,4,4978,0.099211920834331
"58",543,"ED ETOH/ALTERED MENTAL STATUS",147,"10467","LORAZEPAM 2 MG/ML INJ SOLN",1,8,0.054421768707483,749,20621,0.125,0.0363221958197954,3.44142189586115,7,19872,0.692745738725335
"59",543,"ED ETOH/ALTERED MENTAL STATUS",147,"520094","MULTIVITAMINS (+ FOLIC ACID, THIAMINE, VIT K) IVPB",1,6,0.0408163265306122,109,1474,0.166666666666667,0.0739484396200814,2.25382262996942,5,1365,0.932816017719159
"60",543,"ED ETOH/ALTERED MENTAL STATUS",147,"540102","NS IV BOLUS",2,31,0.210884353741497,2225,80957,0.0645161290322581,0.0274837259285794,2.3474302283436,29,78732,0.476859945095999
"61",543,"ED ETOH/ALTERED MENTAL STATUS",147,"540300","MORPHINE INJECTABLE SYRINGE",1,1,0.00680272108843537,61,1002,1,0.0608782435129741,16.4262295081967,0,941,0.0686866302622316
"62",547,"ED GENERAL COMPLAINT",2569,"5172","MORPHINE 4 MG/ML INJ SYRG",4,94,0.0365901128843908,238,5949,0.0425531914893617,0.0400067238191293,1.06365099231182,90,5711,0.999999999999996
"63",547,"ED GENERAL COMPLAINT",2569,"12580","IPRATROPIUM BROMIDE 0.02 % INH SOLN",1,10,0.00389256520046711,127,3899,0.1,0.0325724544755065,3.07007874015748,9,3772,0.758847960380584
"64",547,"ED GENERAL COMPLAINT",2569,"94176","ONDANSETRON 4 MG PO TBDL",1,3,0.00116776956014013,153,4277,0.333333333333333,0.0357727379003975,9.31808278867102,2,4124,0.224064876529558
"65",547,"ED GENERAL COMPLAINT",2569,"112586","HYDROMORPHONE 1 MG/ML INJ SYRG",1,103,0.0400934215648112,1219,33427,0.00970873786407767,0.036467526251234,0.266229680543498,102,32208,0.23617666798263
"66",547,"ED GENERAL COMPLAINT",2569,"122689","ALBUTEROL SULFATE 2.5 MG/0.5 ML INH NEBU",1,11,0.00428182172051382,142,1409,0.0909090909090909,0.100780695528744,0.902048655569782,10,1267,0.999999999999965
"67",547,"ED GENERAL COMPLAINT",2569,"198509","ONDANSETRON HCL (PF) 4 MG/2 ML INJ SOLN",1,193,0.0751265083690152,705,36939,0.00518134715025907,0.0190855193697718,0.271480542387829,192,36234,0.251598965076661
"68",547,"ED GENERAL COMPLAINT",2569,"540102","NS IV BOLUS",11,630,0.245231607629428,2225,80957,0.0174603174603175,0.0274837259285794,0.635296593543785,619,78732,0.157796097679712
"69",550,"ED SEIZURE TREATMENT",37,"10467","LORAZEPAM 2 MG/ML INJ SOLN",2,9,0.243243243243243,749,20621,0.222222222222222,0.0363221958197954,6.11808337041982,7,19872,0.0368890631652922
"70",550,"ED SEIZURE TREATMENT",37,"203954","FOSPHENYTOIN 100 MG PE/2 ML INJ SOLN",2,2,0.0540540540540541,9,107,1,0.0841121495327103,11.8888888888889,0,98,0.0020996190510804
"71",571,"PED ED DKA",16,"27838","SODIUM CHLORIDE 0.9 % 0.9 % IV SOLP",1,1,0.0625,692,19620,1,0.0352701325178389,28.3526011560694,0,18928,0.0118194121841506
"72",571,"PED ED DKA",16,"570056","INSULIN REGULAR 0.1 UNIT/ML PEDIATRIC IV INFUSION",1,2,0.125,2,3,0.5,0.666666666666667,0.75,1,1,1
"73",571,"PED ED DKA",16,"570057","INSULIN REGULAR 1 UNIT/ML PEDIATRIC IV INFUSION",1,2,0.125,6,10,0.5,0.6,0.833333333333333,1,4,1
"74",591,"NURSING TRIAGE CARDIAC COMPLAINTS PROTOCOL",1097,"680","ASPIRIN 81 MG PO CHEW",15,116,0.105742935278031,357,11203,0.129310344827586,0.031866464339909,4.05788177339902,101,10846,2.20966158120887e-08
"75",591,"NURSING TRIAGE CARDIAC COMPLAINTS PROTOCOL",1097,"5604","NITROGLYCERIN 0.4 MG SL SUBL",10,96,0.0875113947128532,77,2947,0.104166666666667,0.0261282660332542,3.98674242424242,86,2870,2.62239881186508e-05
"76",592,"NURSING TRIAGE COPD PROTOCOL",98,"101","ACETAMINOPHEN 325 MG PO TABS",2,5,0.0510204081632653,981,42092,0.4,0.0233060914187969,17.1628950050968,3,41111,4.19328604996452e-05
"77",592,"NURSING TRIAGE COPD PROTOCOL",98,"12580","IPRATROPIUM BROMIDE 0.02 % INH SOLN",1,17,0.173469387755102,127,3899,0.0588235294117647,0.0325724544755065,1.80592867068087,16,3772,0.999999999999899
"78",592,"NURSING TRIAGE COPD PROTOCOL",98,"122689","ALBUTEROL SULFATE 2.5 MG/0.5 ML INH NEBU",2,9,0.0918367346938776,142,1409,0.222222222222222,0.100780695528744,2.20500782472613,7,1267,0.516481576855816
"79",598,"NURSING TRIAGE ABDOMINAL PAIN PROTOCOL",760,"112586","HYDROMORPHONE 1 MG/ML INJ SYRG",8,95,0.125,1219,33427,0.0842105263157895,0.036467526251234,2.3091921765036,87,32208,0.0277376599148412
"80",598,"NURSING TRIAGE ABDOMINAL PAIN PROTOCOL",760,"198509","ONDANSETRON HCL (PF) 4 MG/2 ML INJ SOLN",1,111,0.146052631578947,705,36939,0.00900900900900901,0.0190855193697718,0.472033735863523,110,36234,0.66887279964401
"81",609,"IP PSY PSYCHIATRY INPATIENT ADMIT",6251,"101","ACETAMINOPHEN 325 MG PO TABS",9,986,0.15773476243801,981,42092,0.00912778904665314,0.0233060914187969,0.391648212590952,977,41111,0.00466314526492194
"82",609,"IP PSY PSYCHIATRY INPATIENT ADMIT",6251,"102","ACETAMINOPHEN 500 MG PO TABS",1,26,0.00415933450647896,392,15968,0.0384615384615385,0.0245490981963928,1.56671899529042,25,15576,0.999999999999926
"83",609,"IP PSY PSYCHIATRY INPATIENT ADMIT",6251,"1755","CLONIDINE HCL 0.1 MG PO TABS",1,9,0.0014397696368581,104,2839,0.111111111111111,0.0366326171187038,3.03311965811966,8,2735,0.765714822380169
"84",609,"IP PSY PSYCHIATRY INPATIENT ADMIT",6251,"2509","DIPHENHYDRAMINE HCL 25 MG PO CAPS",2,118,0.0188769796832507,356,12049,0.0169491525423729,0.0295460204166321,0.573652637592839,116,11693,0.594665094718473
"85",609,"IP PSY PSYCHIATRY INPATIENT ADMIT",6251,"2566","DOCUSATE SODIUM 100 MG PO CAPS",4,695,0.111182210846265,542,37509,0.00575539568345324,0.0144498653656456,0.398300990204147,691,36967,0.0797307046210229
"86",609,"IP PSY PSYCHIATRY INPATIENT ADMIT",6251,"2567","DOCUSATE SODIUM 250 MG PO CAPS",4,338,0.0540713485842265,296,17760,0.0118343195266272,0.0166666666666667,0.710059171597633,334,17464,0.635305546859246
"87",609,"IP PSY PSYCHIATRY INPATIENT ADMIT",6251,"3233","FOLIC ACID 1 MG PO TABS",1,84,0.013437849944009,58,4621,0.0119047619047619,0.0125513958017745,0.948481116584565,83,4563,0.999999999999999
"88",609,"IP PSY PSYCHIATRY INPATIENT ADMIT",6251,"3774","HYDROXYZINE HCL 25 MG PO TABS",7,473,0.0756678931370981,133,4979,0.0147991543340381,0.0267121912030528,0.554022476911094,466,4846,0.157582770437956
"89",609,"IP PSY PSYCHIATRY INPATIENT ADMIT",6251,"3843","IBUPROFEN 400 MG PO TABS",6,363,0.0580707086866101,148,4216,0.0165289256198347,0.0351043643263757,0.470851016305562,357,4068,0.08327534912658
"90",609,"IP PSY PSYCHIATRY INPATIENT ADMIT",6251,"3845","IBUPROFEN 800 MG PO TABS",1,17,0.00271956486962086,25,565,0.0588235294117647,0.0442477876106195,1.32941176470588,16,540,0.999999999999999
"91",609,"IP PSY PSYCHIATRY INPATIENT ADMIT",6251,"4572","LORAZEPAM 0.5 MG PO TABS",2,35,0.00559910414333707,349,13238,0.0571428571428571,0.0263634990179785,2.16749897666803,33,12889,0.544552135408463
"92",609,"IP PSY PSYCHIATRY INPATIENT ADMIT",6251,"4573","LORAZEPAM 1 MG PO TABS",7,162,0.0259158534634459,337,8494,0.0432098765432099,0.0396750647515894,1.08909403963806,155,8157,0.979942716961932
"93",609,"IP PSY PSYCHIATRY INPATIENT ADMIT",6251,"4574","LORAZEPAM 2 MG PO TABS",1,10,0.00159974404095345,31,618,0.1,0.0501618122977346,1.99354838709677,9,587,0.999999999999963
"94",609,"IP PSY PSYCHIATRY INPATIENT ADMIT",6251,"7876","THIAMINE HCL (VITAMIN B1) 100 MG/ML INJ SOLN",1,22,0.00351943689009758,145,981,0.0454545454545455,0.147808358817533,0.307523510971787,21,836,0.298044905960772
"95",609,"IP PSY PSYCHIATRY INPATIENT ADMIT",6251,"7877","THIAMINE HCL (VITAMIN B1) 100 MG PO TABS",1,76,0.0121580547112462,100,3808,0.0131578947368421,0.0262605042016807,0.501052631578947,75,3708,0.728802690204205
"96",609,"IP PSY PSYCHIATRY INPATIENT ADMIT",6251,"8085","TRAZODONE 50 MG PO TABS",3,178,0.0284754439289714,334,11344,0.0168539325842697,0.0294428772919605,0.572428177353159,175,11010,0.444336713158395
"97",609,"IP PSY PSYCHIATRY INPATIENT ADMIT",6251,"9637","CLONAZEPAM 0.5 MG PO TABS",2,25,0.00399936010238362,108,3358,0.08,0.0321620011911852,2.48740740740741,23,3250,0.436757766040088
"98",609,"IP PSY PSYCHIATRY INPATIENT ADMIT",6251,"10717","NICOTINE (POLACRILEX) 2 MG BUCCAL GUM",1,104,0.0166373380259159,19,871,0.00961538461538462,0.0218140068886338,0.440789473684211,103,852,0.642969990222206
"99",609,"IP PSY PSYCHIATRY INPATIENT ADMIT",6251,"11349","SENNOSIDES 8.6 MG PO TABS",5,584,0.0934250519916813,610,35793,0.00856164383561644,0.0170424384656218,0.502371996406917,579,35183,0.157033728530506
"100",609,"IP PSY PSYCHIATRY INPATIENT ADMIT",6251,"16830","MELATONIN 3 MG PO TABS",3,157,0.0251159814429691,456,17087,0.0191082802547771,0.0266869549950255,0.716015755950385,154,16631,0.735203404709836
"101",609,"IP PSY PSYCHIATRY INPATIENT ADMIT",6251,"27860","NICOTINE 7 MG/24 HR TD PT24",1,23,0.00367941129419293,23,953,0.0434782608695652,0.0241343126967471,1.80151228733459,22,930,0.999999999999978
"102",609,"IP PSY PSYCHIATRY INPATIENT ADMIT",6251,"27862","NICOTINE 14 MG/24 HR TD PT24",1,52,0.00831866901295793,28,1507,0.0192307692307692,0.0185799601857996,1.03502747252747,51,1479,0.999999999999997
"103",609,"IP PSY PSYCHIATRY INPATIENT ADMIT",6251,"27863","NICOTINE 21 MG/24 HR TD PT24",1,44,0.00703887378019517,23,1042,0.0227272727272727,0.0220729366602687,1.0296442687747,43,1019,0.999999999999999
"104",609,"IP PSY PSYCHIATRY INPATIENT ADMIT",6251,"38390","ALUM-MAG HYDROXIDE-SIMETH 400-400-40 MG/5 ML PO SUSP",2,440,0.0703887378019517,14,882,0.00454545454545455,0.0158730158730159,0.286363636363636,438,868,0.131543168359831
"105",609,"IP PSY PSYCHIATRY INPATIENT ADMIT",6251,"80840","ONDANSETRON HCL 8 MG PO TABS",1,218,0.0348744200927852,170,10077,0.00458715596330275,0.0168701002282425,0.271910415542364,217,9907,0.255923738497241
"106",609,"IP PSY PSYCHIATRY INPATIENT ADMIT",6251,"81141","ONDANSETRON HCL 4 MG PO TABS",1,14,0.00223964165733483,87,4024,0.0714285714285714,0.0216202783300199,3.30377668308703,13,3937,0.720810576386406
"107",609,"IP PSY PSYCHIATRY INPATIENT ADMIT",6251,"84520","ONDANSETRON 8 MG PO TBDL",2,28,0.00447928331466965,153,4394,0.0714285714285714,0.0348202093764224,2.05135387488329,26,4241,0.592970534874936
"108",609,"IP PSY PSYCHIATRY INPATIENT ADMIT",6251,"92173","ZOLPIDEM 5 MG PO TABS",3,37,0.00591905295152776,159,8203,0.0810810810810811,0.019383152505181,4.18306986231515,34,8044,0.035398517062158
"109",609,"IP PSY PSYCHIATRY INPATIENT ADMIT",6251,"540598","THERAPEUTIC MULTIVITAMIN & MINERALS (GENERIC) PO TABS",1,140,0.0223964165733483,17,1250,0.00714285714285714,0.0136,0.525210084033613,139,1233,0.805142527868802
"110",609,"IP PSY PSYCHIATRY INPATIENT ADMIT",6251,"9000000","ZZZ IMS TEMPLATE",1,9,0.0014397696368581,1035,28824,0.111111111111111,0.0359075770191507,3.09436392914654,8,27789,0.751719783873197
"111",611,"IP ASC PSY ECT",1777,"4318","LACTATED RINGERS IV SOLP",94,1111,0.625211029825549,135,4847,0.0846084608460846,0.0278522797606767,3.03775710904424,1017,4712,1.5072019695937e-18
"112",616,"IP PAI EPIDURAL ANALGESIA POSTOP",6394,"2508","DIPHENHYDRAMINE HCL 50 MG/ML INJ SOLN",9,601,0.093994369721614,399,16019,0.0149750415973378,0.0249079218428117,0.601216018415423,592,15620,0.158351002475462
"113",616,"IP PAI EPIDURAL ANALGESIA POSTOP",6394,"5339","NALBUPHINE 10 MG/ML INJ SOLN",10,975,0.152486706287144,3,308,0.0102564102564103,0.00974025974025974,1.05299145299145,965,305,1
"114",616,"IP PAI EPIDURAL ANALGESIA POSTOP",6394,"5340","NALBUPHINE 20 MG/ML INJ SOLN",1,107,0.0167344385361276,1,129,0.00934579439252336,0.00775193798449612,1.20560747663551,106,128,0.999999999999993
"115",616,"IP PAI EPIDURAL ANALGESIA POSTOP",6394,"29464","MORPHINE (PF) 0.5 MG/ML INJ SOLN",1,2,0.000312793243665937,7,23,0.5,0.304347826086957,1.64285714285714,1,16,0.999999999999999
"116",616,"IP PAI EPIDURAL ANALGESIA POSTOP",6394,"530032","BUPIVACAINE 0.125% (1/8%) EPIDURAL INFUSION",30,2314,0.361901782921489,5,132,0.0129645635263613,0.0378787878787879,0.342264477095938,2284,127,0.0491208316502799
"117",616,"IP PAI EPIDURAL ANALGESIA POSTOP",6394,"530033","BUPIVACAINE 0.25% (1/4%) EPIDURAL INFUSION",2,79,0.0123553331248045,1,18,0.0253164556962025,0.0555555555555556,0.455696202531646,77,17,0.999999999999994
"118",616,"IP PAI EPIDURAL ANALGESIA POSTOP",6394,"530051","LIDOCAINE 1% EPIDURAL INFUSION",7,190,0.029715358148264,1,20,0.0368421052631579,0.05,0.736842105263158,183,19,0.999999999999999
"119",616,"IP PAI EPIDURAL ANALGESIA POSTOP",6394,"530104","HYDROMORPHONE 0.05 MG/ML EPIDURAL INFUSION",35,1683,0.263215514544886,9,116,0.0207961972667855,0.0775862068965517,0.268039875883013,1648,107,0.000432806595323392
"120",616,"IP PAI EPIDURAL ANALGESIA POSTOP",6394,"540106","FENTANYL (PF) 50 MCG/ML INJECTION",2,33,0.00516108852048796,461,18637,0.0606060606060606,0.0247357407308043,2.45014132649707,31,18176,0.445060061892013
"121",616,"IP PAI EPIDURAL ANALGESIA POSTOP",6394,"540107","FENTANYL 50 MCG/ML EPIDURAL PCEA",52,1763,0.275727244291523,5,55,0.029495178672717,0.0909090909090909,0.324446965399887,1711,50,0.0291968227685402
"122",616,"IP PAI EPIDURAL ANALGESIA POSTOP",6394,"540205","LIDOCAINE 1% INFUSION",4,16,0.00250234594932749,1,16,0.25,0.0625,4,12,15,0.330191118603343
"123",616,"IP PAI EPIDURAL ANALGESIA POSTOP",6394,"540541","FENTANYL/BUPIVACAINE PCEA 30 ML SYRINGE",13,166,0.0259618392242728,4,20,0.0783132530120482,0.2,0.391566265060241,153,16,0.169644769901168
"124",616,"IP PAI EPIDURAL ANALGESIA POSTOP",6394,"541064","HYDROMORPHONE EPIDURAL INJECTION",13,284,0.044416640600563,4,82,0.0457746478873239,0.0487804878048781,0.938380281690141,271,78,0.999999999999999
"125",616,"IP PAI EPIDURAL ANALGESIA POSTOP",6394,"541604","FENTANYL 50 MCG/ML EPIDURAL PCEA",15,550,0.0860181420081326,4,26,0.0272727272727273,0.153846153846154,0.177272727272727,535,22,0.00298483030712576
"126",618,"IP PAI PERIPHERAL NERVE CATHETER/REGIONAL ANALGESIA ADMIT",10324,"101","ACETAMINOPHEN 325 MG PO TABS",24,1916,0.185586981790004,981,42092,0.0125260960334029,0.0233060914187969,0.537460177612636,1892,41111,0.00260356874758031
"127",618,"IP PAI PERIPHERAL NERVE CATHETER/REGIONAL ANALGESIA ADMIT",10324,"102","ACETAMINOPHEN 500 MG PO TABS",21,947,0.0917280123982952,392,15968,0.0221752903907075,0.0245490981963928,0.903303665711269,926,15576,0.725196596015492
"128",618,"IP PAI PERIPHERAL NERVE CATHETER/REGIONAL ANALGESIA ADMIT",10324,"1080","BISACODYL 10 MG PR SUPP",3,263,0.0254746222394421,344,22442,0.0114068441064639,0.0153284021031994,0.7441639402246,260,22098,0.792850101750838
"129",618,"IP PAI PERIPHERAL NERVE CATHETER/REGIONAL ANALGESIA ADMIT",10324,"2566","DOCUSATE SODIUM 100 MG PO CAPS",8,908,0.0879504068190624,542,37509,0.00881057268722467,0.0144498653656456,0.609733894695775,900,36967,0.203336329899897
"130",618,"IP PAI PERIPHERAL NERVE CATHETER/REGIONAL ANALGESIA ADMIT",10324,"5373","NALOXONE 0.4 MG/ML INJ SOLN",53,3956,0.383184812088338,83,1774,0.0133973710819009,0.0467869222096956,0.286348630111954,3903,1691,3.38636059699585e-14
"131",618,"IP PAI PERIPHERAL NERVE CATHETER/REGIONAL ANALGESIA ADMIT",10324,"5940","OXYCODONE-ACETAMINOPHEN 5-325 MG PO TABS",1,2,0.000193723363037582,218,7862,0.5,0.0277283134062579,18.0321100917431,1,7644,0.0561791108300188
"132",618,"IP PAI PERIPHERAL NERVE CATHETER/REGIONAL ANALGESIA ADMIT",10324,"10814","OXYCODONE 5 MG PO TABS",104,3774,0.365555986051918,1478,56614,0.0275569687334393,0.0261066167379094,1.0555549579668,3670,55136,0.625903474582416
"133",618,"IP PAI PERIPHERAL NERVE CATHETER/REGIONAL ANALGESIA ADMIT",10324,"11349","SENNOSIDES 8.6 MG PO TABS",10,718,0.0695466873304921,610,35793,0.0139275766016713,0.0170424384656218,0.817229097219051,708,35183,0.621478989492255
"134",618,"IP PAI PERIPHERAL NERVE CATHETER/REGIONAL ANALGESIA ADMIT",10324,"18308","GABAPENTIN 300 MG PO CAPS",53,1973,0.191108097636575,588,19458,0.026862645717182,0.0302189330866482,0.888934286334909,1920,18870,0.444515253342906
"135",618,"IP PAI PERIPHERAL NERVE CATHETER/REGIONAL ANALGESIA ADMIT",10324,"18309","GABAPENTIN 100 MG PO CAPS",15,845,0.0818481208833785,199,6318,0.0177514792899408,0.0314973092750871,0.563587166602242,830,6119,0.0360192118449499
"136",618,"IP PAI PERIPHERAL NERVE CATHETER/REGIONAL ANALGESIA ADMIT",10324,"25424","POLYETHYLENE GLYCOL 3350 17 GRAM PO PWPK",3,374,0.0362262688880279,712,36910,0.00802139037433155,0.0192901652668653,0.41582797572553,371,36198,0.164059436991192
"137",618,"IP PAI PERIPHERAL NERVE CATHETER/REGIONAL ANALGESIA ADMIT",10324,"27920","OXYCODONE 10 MG PO TB12",14,288,0.0278961642774119,258,7208,0.0486111111111111,0.0357935627081021,1.35809646856159,274,6950,0.327099500909072
"138",618,"IP PAI PERIPHERAL NERVE CATHETER/REGIONAL ANALGESIA ADMIT",10324,"27921","OXYCODONE 20 MG PO TB12",1,34,0.0032932971716389,93,2927,0.0294117647058824,0.0317731465664503,0.925679949399114,33,2834,0.999999999999996
"139",618,"IP PAI PERIPHERAL NERVE CATHETER/REGIONAL ANALGESIA ADMIT",10324,"27922","OXYCODONE 40 MG PO TB12",1,19,0.00184037194885703,47,1081,0.0526315789473684,0.0434782608695652,1.21052631578947,18,1034,0.999999999999998
"140",618,"IP PAI PERIPHERAL NERVE CATHETER/REGIONAL ANALGESIA ADMIT",10324,"28899","OXYCODONE 15 MG PO TABS",1,26,0.00251840371948857,51,1050,0.0384615384615385,0.0485714285714286,0.79185520361991,25,999,0.999999999999983
"141",618,"IP PAI PERIPHERAL NERVE CATHETER/REGIONAL ANALGESIA ADMIT",10324,"34505","HYDROCODONE-ACETAMINOPHEN 5-325 MG PO TABS",1,12,0.00116234017822549,603,24164,0.0833333333333333,0.0249544777354743,3.33941404090658,11,23561,0.711100430991499
"142",618,"IP PAI PERIPHERAL NERVE CATHETER/REGIONAL ANALGESIA ADMIT",10324,"77052","CELECOXIB 200 MG PO CAPS",13,237,0.0229562185199535,20,1192,0.0548523206751055,0.0167785234899329,3.26919831223629,224,1172,0.000876659532486715
"143",618,"IP PAI PERIPHERAL NERVE CATHETER/REGIONAL ANALGESIA ADMIT",10324,"93715","CELECOXIB 100 MG PO CAPS",25,986,0.0955056179775281,42,1272,0.0253549695740365,0.0330188679245283,0.767893364242249,961,1230,0.347502902880716
"144",618,"IP PAI PERIPHERAL NERVE CATHETER/REGIONAL ANALGESIA ADMIT",10324,"125758","PREGABALIN 75 MG PO CAPS",1,39,0.00377760557923286,31,1474,0.0256410256410256,0.0210312075983718,1.2191894127378,38,1443,1
"145",618,"IP PAI PERIPHERAL NERVE CATHETER/REGIONAL ANALGESIA ADMIT",10324,"125759","PREGABALIN 100 MG PO CAPS",1,5,0.000484308407593956,13,833,0.2,0.0156062424969988,12.8153846153846,4,820,0.144974943390625
"146",618,"IP PAI PERIPHERAL NERVE CATHETER/REGIONAL ANALGESIA ADMIT",10324,"198509","ONDANSETRON HCL (PF) 4 MG/2 ML INJ SOLN",11,825,0.0799108872530027,705,36939,0.0133333333333333,0.0190855193697718,0.698609929078014,814,36234,0.285038086590935
"147",618,"IP PAI PERIPHERAL NERVE CATHETER/REGIONAL ANALGESIA ADMIT",10324,"211398","ROPIVACAINE (PF) 0.2 % 550 ML LINF ELPH",5,215,0.0208252615265401,20,425,0.0232558139534884,0.0470588235294118,0.494186046511628,210,405,0.210561129552813
"148",618,"IP PAI PERIPHERAL NERVE CATHETER/REGIONAL ANALGESIA ADMIT",10324,"233900","OXYCODONE 10 MG PO TR12",2,65,0.00629600929872143,38,949,0.0307692307692308,0.0400421496311907,0.768421052631579,63,911,0.966322168493397
"149",618,"IP PAI PERIPHERAL NERVE CATHETER/REGIONAL ANALGESIA ADMIT",10324,"520183","BUPIVACAINE 0.125% (1/8%) NERVE BLOCK INFUSION",27,1525,0.147714064316157,8,165,0.0177049180327869,0.0484848484848485,0.365163934426229,1498,157,0.018796710488868
"150",618,"IP PAI PERIPHERAL NERVE CATHETER/REGIONAL ANALGESIA ADMIT",10324,"520184","BUPIVACAINE 0.25% (1/4%) NERVE BLOCK INFUSION",22,1830,0.177256877179388,6,202,0.0120218579234973,0.0297029702970297,0.404735883424408,1808,196,0.0840395314076258
"151",618,"IP PAI PERIPHERAL NERVE CATHETER/REGIONAL ANALGESIA ADMIT",10324,"540202","ROPIVACAINE 0.1% NERVE BLOCK INFUSION",16,209,0.0202440914374274,2,13,0.076555023923445,0.153846153846154,0.497607655502392,193,11,0.640500919916039
"152",618,"IP PAI PERIPHERAL NERVE CATHETER/REGIONAL ANALGESIA ADMIT",10324,"540205","LIDOCAINE 1% INFUSION",3,71,0.00687717938783417,1,16,0.0422535211267606,0.0625,0.676056338028169,68,15,0.999999999999994
"153",618,"IP PAI PERIPHERAL NERVE CATHETER/REGIONAL ANALGESIA ADMIT",10324,"540207","ROPIVACAINE 0.2% 400 ML 2-14 ML ANESTHETIC PUMP",16,171,0.0165633475397133,2,30,0.0935672514619883,0.0666666666666667,1.40350877192982,155,28,0.897094286567087
"154",618,"IP PAI PERIPHERAL NERVE CATHETER/REGIONAL ANALGESIA ADMIT",10324,"540470","BUPIVACAINE 0.125% 400 ML 2-14 ML ANESTHETIC PUMP",2,13,0.00125920185974429,1,24,0.153846153846154,0.0416666666666667,3.69230769230769,11,23,0.573700502098691
"155",618,"IP PAI PERIPHERAL NERVE CATHETER/REGIONAL ANALGESIA ADMIT",10324,"540475","BUPIVACAINE 0.25% 400 ML 2-14 ML ANESTHETIC PUMP",5,14,0.00135606354126308,1,34,0.357142857142857,0.0294117647058824,12.1428571428571,9,33,0.00827769135810255
"156",618,"IP PAI PERIPHERAL NERVE CATHETER/REGIONAL ANALGESIA ADMIT",10324,"541178","ROPIVACAINE 0.2% NERVE BLOCK INFUSION (PREMIX)",9,257,0.0248934521503293,1,6,0.0350194552529183,0.166666666666667,0.21011673151751,248,5,0.55716433822452
"157",619,"IP PAI SCIPP CHRONIC PAIN ADMIT",364,"93295","ZOLPIDEM 10 MG PO TABS",1,7,0.0192307692307692,33,1662,0.142857142857143,0.01985559566787,7.19480519480519,6,1629,0.337940134100052
"158",619,"IP PAI SCIPP CHRONIC PAIN ADMIT",364,"110892","ENOXAPARIN 40 MG/0.4 ML SC SYRG",1,2,0.00549450549450549,499,13896,0.5,0.0359096142774899,13.9238476953908,1,13397,0.10408135842914
"159",619,"IP PAI SCIPP CHRONIC PAIN ADMIT",364,"540000","PAIN COCKTAIL",1,105,0.288461538461538,57,1525,0.00952380952380952,0.0373770491803279,0.254803675856307,104,1468,0.223251461731937
"160",623,"IP PAI KETAMINE IV",358,"4572","LORAZEPAM 0.5 MG PO TABS",3,93,0.259776536312849,349,13238,0.032258064516129,0.0263634990179785,1.22358813199002,90,12889,0.97702679729596
"161",623,"IP PAI KETAMINE IV",358,"530034","KETAMINE 5 MG/ML IV INFUSION",2,160,0.446927374301676,31,480,0.0125,0.0645833333333333,0.193548387096774,158,449,0.0176160532687648
"162",624,"ANE PACU (OUTPATIENT)",7783,"101","ACETAMINOPHEN 325 MG PO TABS",1,73,0.00937941667737376,981,42092,0.0136986301369863,0.0233060914187969,0.587770376886878,72,41111,0.876473725484369
"163",624,"ANE PACU (OUTPATIENT)",7783,"102","ACETAMINOPHEN 500 MG PO TABS",23,531,0.0682256199408968,392,15968,0.0433145009416196,0.0245490981963928,1.76440293631577,508,15576,0.0100000979565167
"164",624,"ANE PACU (OUTPATIENT)",7783,"730","ATROPINE 0.1 MG/ML INJ SYRG",1,19,0.00244121803931646,11,381,0.0526315789473684,0.0288713910761155,1.82296650717703,18,370,1
"165",624,"ANE PACU (OUTPATIENT)",7783,"2332","DEXAMETHASONE SODIUM PHOSPHATE 4 MG/ML INJ SOLN",10,314,0.0403443402287036,390,6737,0.0318471337579618,0.0578892682202761,0.550138820839458,304,6347,0.067974568413664
"166",624,"ANE PACU (OUTPATIENT)",7783,"3497","GLYCOPYRROLATE 0.2 MG/ML INJ SOLN",13,318,0.0408582808685597,61,1031,0.0408805031446541,0.0591658583899127,0.690947520362924,305,970,0.266534744562113
"167",624,"ANE PACU (OUTPATIENT)",7783,"4318","LACTATED RINGERS IV SOLP",96,2947,0.378645766413979,135,4847,0.0325755005089922,0.0278522797606767,1.16958111827471,2851,4712,0.261247472573188
"168",624,"ANE PACU (OUTPATIENT)",7783,"5002","METOCLOPRAMIDE HCL 5 MG/ML INJ SOLN",9,428,0.0549916484646023,346,10128,0.0210280373831776,0.0341627172195893,0.615525903516828,419,9782,0.180382589128349
"169",624,"ANE PACU (OUTPATIENT)",7783,"5007","METOPROLOL TARTRATE 5 MG/5 ML IV SOLN",5,132,0.0169600411152512,745,12385,0.0378787878787879,0.0601534113847396,0.629703070978239,127,11640,0.374409186028367
"170",624,"ANE PACU (OUTPATIENT)",7783,"5339","NALBUPHINE 10 MG/ML INJ SOLN",7,182,0.0233842991134524,3,308,0.0384615384615385,0.00974025974025974,3.94871794871795,175,305,0.0654693216055104
"171",624,"ANE PACU (OUTPATIENT)",7783,"5373","NALOXONE 0.4 MG/ML INJ SOLN",39,1325,0.170242836952332,83,1774,0.0294339622641509,0.0467869222096956,0.629106615139804,1286,1691,0.0180701276701051
"172",624,"ANE PACU (OUTPATIENT)",7783,"5940","OXYCODONE-ACETAMINOPHEN 5-325 MG PO TABS",9,237,0.0304509829114737,218,7862,0.0379746835443038,0.0277283134062579,1.36952734873998,228,7644,0.458153945400246
"173",624,"ANE PACU (OUTPATIENT)",7783,"6618","PROMETHAZINE 25 MG/ML INJ SOLN",38,1271,0.163304638314275,289,5149,0.029897718332022,0.056127403379297,0.532675957410316,1233,4860,0.000185694397555465
"174",624,"ANE PACU (OUTPATIENT)",7783,"10372","LABETALOL 5 MG/ML IV SOLN",14,540,0.069381986380573,370,5898,0.0259259259259259,0.0627331298745337,0.413273273273273,526,5528,0.000774217216845612
"175",624,"ANE PACU (OUTPATIENT)",7783,"10814","OXYCODONE 5 MG PO TABS",23,1182,0.151869459077477,1478,56614,0.0194585448392555,0.0261066167379094,0.745349159356976,1159,55136,0.183548937693976
"176",624,"ANE PACU (OUTPATIENT)",7783,"18308","GABAPENTIN 300 MG PO CAPS",1,46,0.00591031735834511,588,19458,0.0217391304347826,0.0302189330866482,0.719387755102041,45,18870,0.999999999999906
"177",624,"ANE PACU (OUTPATIENT)",7783,"27838","SODIUM CHLORIDE 0.9 % 0.9 % IV SOLP",33,970,0.124630605165103,692,19620,0.034020618556701,0.0352701325178389,0.964573029020916,937,18928,0.906957223457993
"178",624,"ANE PACU (OUTPATIENT)",7783,"27920","OXYCODONE 10 MG PO TB12",1,18,0.00231273287935243,258,7208,0.0555555555555556,0.0357935627081021,1.55211024978467,17,6950,0.999999999999816
"179",624,"ANE PACU (OUTPATIENT)",7783,"34505","HYDROCODONE-ACETAMINOPHEN 5-325 MG PO TABS",14,416,0.0534498265450341,603,24164,0.0336538461538462,0.0249544777354743,1.34860951651996,402,23561,0.333771740303041
"180",624,"ANE PACU (OUTPATIENT)",7783,"93305","SCOPOLAMINE BASE 1.5 MG (1 MG OVER 3 DAYS) TD PT3D",8,207,0.026596428112553,93,5289,0.0386473429951691,0.0175836642087351,2.19791179678978,199,5196,0.0512112057252685
"181",624,"ANE PACU (OUTPATIENT)",7783,"110872","HYDROMORPHONE 2 MG/ML INJ SYRG",43,1494,0.191956828986252,738,23934,0.0287817938420348,0.0308347956881424,0.93341931411282,1451,23196,0.712191483211845
"182",624,"ANE PACU (OUTPATIENT)",7783,"112586","HYDROMORPHONE 1 MG/ML INJ SYRG",2,615,0.0790183733778749,1219,33427,0.0032520325203252,0.036467526251234,0.0891761206373343,613,32208,1.86942285079479e-05
"183",624,"ANE PACU (OUTPATIENT)",7783,"125758","PREGABALIN 75 MG PO CAPS",1,3,0.000385455479892072,31,1474,0.333333333333333,0.0210312075983718,15.8494623655914,2,1443,0.0842014042056066
"184",624,"ANE PACU (OUTPATIENT)",7783,"126009","MEPERIDINE (PF) 25 MG/ML INJ SYRG",12,534,0.0686110754207889,164,2764,0.0224719101123595,0.0593342981186686,0.378733899698548,522,2600,0.000767063463258679
"185",624,"ANE PACU (OUTPATIENT)",7783,"198509","ONDANSETRON HCL (PF) 4 MG/2 ML INJ SOLN",103,3276,0.420917384042143,705,36939,0.0314407814407814,0.0190855193697718,1.64736315693763,3173,36234,1.88597344093615e-06
"186",624,"ANE PACU (OUTPATIENT)",7783,"200439","HYDROMORPHONE (PF) 2 MG/ML INJ SOLN",2,104,0.0133624566362585,142,3356,0.0192307692307692,0.0423122765196663,0.454496208017335,102,3214,0.362038163099978
"187",624,"ANE PACU (OUTPATIENT)",7783,"212629","ACETAMINOPHEN 1,000 MG/100 ML (10 MG/ML) IV SOLN",8,415,0.05332134138507,510,18335,0.0192771084337349,0.0278156531224434,0.693030947318687,407,17825,0.369170675854479
"188",624,"ANE PACU (OUTPATIENT)",7783,"540102","NS IV BOLUS",3,66,0.00848002055762559,2225,80957,0.0454545454545455,0.0274837259285794,1.65387129724208,63,78732,0.60592437582615
"189",624,"ANE PACU (OUTPATIENT)",7783,"540106","FENTANYL (PF) 50 MCG/ML INJECTION",106,3437,0.441603494796351,461,18637,0.0308408495781205,0.0247357407308043,1.24681326157794,3331,18176,0.0433614247349804
"190",624,"ANE PACU (OUTPATIENT)",7783,"540115","LACTATED RINGERS IV BOLUS",1,103,0.0132339714762945,400,12941,0.00970873786407767,0.0309095124024419,0.314101941747573,102,12541,0.33957564791445
"191",624,"ANE PACU (OUTPATIENT)",7783,"540300","MORPHINE INJECTABLE SYRINGE",4,106,0.0136194269561866,61,1002,0.0377358490566038,0.0608782435129741,0.619857717290442,102,941,0.455135617190192
"192",624,"ANE PACU (OUTPATIENT)",7783,"541048","HYDROMORPHONE VARIABLE DOSE INJECTION",2,49,0.00629577283823718,104,5739,0.0408163265306122,0.0181216239763025,2.25235478806907,47,5635,0.519060642384769
"193",624,"ANE PACU (OUTPATIENT)",7783,"541229","ELECTROLYTE-R IV BOLUS",1,2,0.000256970319928048,92,2706,0.5,0.0339985218033999,14.7065217391304,1,2614,0.0938614899016372
"194",625,"ANE PACU (INPATIENT)",65802,"101","ACETAMINOPHEN 325 MG PO TABS",3,102,0.00155010486003465,981,42092,0.0294117647058824,0.0233060914187969,1.26197757390418,99,41111,0.936507419701278
"195",625,"ANE PACU (INPATIENT)",65802,"102","ACETAMINOPHEN 500 MG PO TABS",27,979,0.0148779672350384,392,15968,0.0275791624106231,0.0245490981963928,1.12342873819599,952,15576,0.626519005321447
"196",625,"ANE PACU (INPATIENT)",65802,"730","ATROPINE 0.1 MG/ML INJ SYRG",2,184,0.00279626759065074,11,381,0.0108695652173913,0.0288713910761155,0.376482213438735,182,370,0.299249251144985
"197",625,"ANE PACU (INPATIENT)",65802,"2332","DEXAMETHASONE SODIUM PHOSPHATE 4 MG/ML INJ SOLN",33,1729,0.0262757970882344,390,6737,0.0190861769809138,0.0578892682202761,0.329701472616452,1696,6347,5.97303709140253e-11
"198",625,"ANE PACU (INPATIENT)",65802,"2365","DEXTROSE 50 % IN WATER (D50W) IV SYRG",1,20,0.000303942129418559,134,3551,0.05,0.0377358490566038,1.325,19,3417,0.999999999999998
"199",625,"ANE PACU (INPATIENT)",65802,"2833","EPHEDRINE SULFATE 50 MG/ML INJ SOLN",9,513,0.00779611561958603,4,76,0.0175438596491228,0.0526315789473684,0.333333333333333,504,72,0.127310377220761
"200",625,"ANE PACU (INPATIENT)",65802,"3497","GLYCOPYRROLATE 0.2 MG/ML INJ SOLN",17,1069,0.016245706817422,61,1031,0.0159027128157156,0.0591658583899127,0.268781916606603,1052,970,2.96723335216683e-07
"201",625,"ANE PACU (INPATIENT)",65802,"3697","HYDRALAZINE 20 MG/ML INJ SOLN",45,2541,0.0386158475426279,537,15149,0.0177095631641086,0.0354478843488019,0.499594361961046,2496,14612,4.67758413886206e-06
"202",625,"ANE PACU (INPATIENT)",65802,"3758","HYDROMORPHONE 2 MG/ML INJ SOLN",2,38,0.000577490045895261,2,86,0.0526315789473684,0.0232558139534884,2.26315789473684,36,84,0.762428700080518
"203",625,"ANE PACU (INPATIENT)",65802,"4318","LACTATED RINGERS IV SOLP",172,10108,0.15361235220814,135,4847,0.0170162247724575,0.0278522797606767,0.610945492385936,9936,4712,1.61522693420453e-05
"204",625,"ANE PACU (INPATIENT)",65802,"5002","METOCLOPRAMIDE HCL 5 MG/ML INJ SOLN",76,4764,0.0723990152275007,346,10128,0.0159529806884971,0.0341627172195893,0.466970486743058,4688,9782,5.8815691664221e-10
"205",625,"ANE PACU (INPATIENT)",65802,"5007","METOPROLOL TARTRATE 5 MG/5 ML IV SOLN",16,993,0.0150907267256314,745,12385,0.0161127895266868,0.0601534113847396,0.26786160844029,977,11640,1.2422157612242e-08
"206",625,"ANE PACU (INPATIENT)",65802,"5339","NALBUPHINE 10 MG/ML INJ SOLN",19,1015,0.0154250630679919,3,308,0.0187192118226601,0.00974025974025974,1.92183908045977,996,305,0.40937577052107
"207",625,"ANE PACU (INPATIENT)",65802,"5373","NALOXONE 0.4 MG/ML INJ SOLN",306,19532,0.296829883590164,83,1774,0.0156665984026213,0.0467869222096956,0.334849946581328,19226,1691,1.67421444364117e-20
"208",625,"ANE PACU (INPATIENT)",65802,"5940","OXYCODONE-ACETAMINOPHEN 5-325 MG PO TABS",17,921,0.0139965350597246,218,7862,0.0184581976112921,0.0277283134062579,0.665680502843937,904,7644,0.123188250514051
"209",625,"ANE PACU (INPATIENT)",65802,"6618","PROMETHAZINE 25 MG/ML INJ SOLN",196,13269,0.201650405762743,289,5149,0.0147712713844299,0.056127403379297,0.263173966638164,13073,4860,2.09561403171358e-55
"210",625,"ANE PACU (INPATIENT)",65802,"10372","LABETALOL 5 MG/ML IV SOLN",122,7960,0.120968967508586,370,5898,0.0153266331658291,0.0627331298745337,0.244314817329893,7838,5528,5.57661177781799e-50
"211",625,"ANE PACU (INPATIENT)",65802,"10814","OXYCODONE 5 MG PO TABS",86,4998,0.0759551381416978,1478,56614,0.0172068827531012,0.0261066167379094,0.659100446673933,4912,55136,0.000152149947468476
"212",625,"ANE PACU (INPATIENT)",65802,"18308","GABAPENTIN 300 MG PO CAPS",4,454,0.00689948633780128,588,19458,0.00881057268722467,0.0302189330866482,0.291558032904792,450,18870,0.0118976158674495
"213",625,"ANE PACU (INPATIENT)",65802,"22472","KETOROLAC 15 MG/ML INJ SOLN",1,81,0.00123096562414516,215,5031,0.0123456790123457,0.0427350427350427,0.288888888888889,80,4816,0.284442380219894
"214",625,"ANE PACU (INPATIENT)",65802,"27838","SODIUM CHLORIDE 0.9 % 0.9 % IV SOLP",468,22930,0.348469651378378,692,19620,0.020409943305713,0.0352701325178389,0.57867498216487,22462,18928,8.49580403140399e-21
"215",625,"ANE PACU (INPATIENT)",65802,"27920","OXYCODONE 10 MG PO TB12",2,276,0.00419440138597611,258,7208,0.0072463768115942,0.0357935627081021,0.202449163015392,274,6950,0.0175876712783988
"216",625,"ANE PACU (INPATIENT)",65802,"34505","HYDROCODONE-ACETAMINOPHEN 5-325 MG PO TABS",11,1276,0.019391507856904,603,24164,0.00862068965517241,0.0249544777354743,0.34545662492137,1265,23561,0.000304233981342938
"217",625,"ANE PACU (INPATIENT)",65802,"77052","CELECOXIB 200 MG PO CAPS",1,90,0.00136773958238351,20,1192,0.0111111111111111,0.0167785234899329,0.662222222222222,89,1172,0.999999999999944
"218",625,"ANE PACU (INPATIENT)",65802,"88080","ELECTROLYTE-R (PH 7.4) IV SOLP",2,223,0.00338895474301693,17,349,0.00896860986547085,0.0487106017191977,0.184120284885255,221,332,0.0188915611767859
"219",625,"ANE PACU (INPATIENT)",65802,"93305","SCOPOLAMINE BASE 1.5 MG (1 MG OVER 3 DAYS) TD PT3D",15,1010,0.0153490775356372,93,5289,0.0148514851485149,0.0175836642087351,0.844618332801022,995,5196,0.630763796138196
"220",625,"ANE PACU (INPATIENT)",65802,"110872","HYDROMORPHONE 2 MG/ML INJ SYRG",297,16269,0.247241725175527,738,23934,0.0182555780933063,0.0308347956881424,0.592044723692673,15972,23196,6.98074914191548e-15
"221",625,"ANE PACU (INPATIENT)",65802,"112586","HYDROMORPHONE 1 MG/ML INJ SYRG",169,9382,0.142579252910246,1219,33427,0.0180132167981241,0.036467526251234,0.493952254233711,9213,32208,6.40370180834498e-19
"222",625,"ANE PACU (INPATIENT)",65802,"124521","GRANISETRON (PF) 100 MCG/ML IV SOLN",12,575,0.00873833622078356,2,11,0.0208695652173913,0.181818181818182,0.114782608695652,563,9,0.0136628204161151
"223",625,"ANE PACU (INPATIENT)",65802,"126006","MEPERIDINE (PF) 25 MG/0.5 ML INJ SOLN",1,3,4.55913194127838e-05,34,293,0.333333333333333,0.116040955631399,2.87254901960784,2,259,0.794034526188974
"224",625,"ANE PACU (INPATIENT)",65802,"126009","MEPERIDINE (PF) 25 MG/ML INJ SYRG",60,5615,0.0853317528342604,164,2764,0.0106856634016028,0.0593342981186686,0.180092522207502,5555,2600,4.05834579795508e-38
"225",625,"ANE PACU (INPATIENT)",65802,"198509","ONDANSETRON HCL (PF) 4 MG/2 ML INJ SOLN",505,29495,0.448238655360019,705,36939,0.01712154602475,0.0190855193697718,0.897096154054239,28990,36234,0.0640775769260076
"226",625,"ANE PACU (INPATIENT)",65802,"200439","HYDROMORPHONE (PF) 2 MG/ML INJ SOLN",18,1355,0.0205920792681074,142,3356,0.0132841328413284,0.0423122765196663,0.31395457616548,1337,3214,1.00752622467964e-06
"227",625,"ANE PACU (INPATIENT)",65802,"212629","ACETAMINOPHEN 1,000 MG/100 ML (10 MG/ML) IV SOLN",72,4548,0.0691164402297803,510,18335,0.0158311345646438,0.0278156531224434,0.569144808319106,4476,17825,5.55680556263582e-06
"228",625,"ANE PACU (INPATIENT)",65802,"540102","NS IV BOLUS",21,1080,0.0164128749886022,2225,80957,0.0194444444444444,0.0274837259285794,0.707489388264669,1059,78732,0.129901806926317
"229",625,"ANE PACU (INPATIENT)",65802,"540106","FENTANYL (PF) 50 MCG/ML INJECTION",584,32391,0.492249475699827,461,18637,0.0180296996079158,0.0247357407308043,0.728892649875762,31807,18176,3.09656288651642e-07
"230",625,"ANE PACU (INPATIENT)",65802,"540115","LACTATED RINGERS IV BOLUS",16,940,0.0142852800826723,400,12941,0.0170212765957447,0.0309095124024419,0.55068085106383,924,12541,0.0207632368603546
"231",625,"ANE PACU (INPATIENT)",65802,"540300","MORPHINE INJECTABLE SYRINGE",7,467,0.00709704872192335,61,1002,0.0149892933618844,0.0608782435129741,0.246217572928002,460,941,0.00016679520965692
"232",625,"ANE PACU (INPATIENT)",65802,"540573","ACETAMINOPHEN 10 MG/ML IV (CUSTOM DOSE)",6,166,0.00252271967417404,248,2951,0.036144578313253,0.0840393087089122,0.430091333074232,160,2703,0.0404742131613519
"233",625,"ANE PACU (INPATIENT)",65802,"541048","HYDROMORPHONE VARIABLE DOSE INJECTION",13,878,0.0133430594814747,104,5739,0.0148063781321185,0.0181216239763025,0.817055808656037,865,5635,0.57774492981894
"234",625,"ANE PACU (INPATIENT)",65802,"541229","ELECTROLYTE-R IV BOLUS",1,17,0.000258350810005775,92,2706,0.0588235294117647,0.0339985218033999,1.73017902813299,16,2614,0.999999999999999
"235",625,"ANE PACU (INPATIENT)",65802,"9000000","ZZZ IMS TEMPLATE",1,9,0.000136773958238351,1035,28824,0.111111111111111,0.0359075770191507,3.09436392914654,8,27789,0.751719783873197
"236",637,"IP SUR COLON/RECTAL/SMALL BOWEL RESECTION POSTOP",5576,"101","ACETAMINOPHEN 325 MG PO TABS",18,851,0.152618364418938,981,42092,0.0211515863689777,0.0233060914187969,0.907556140105003,833,41111,0.765739724623315
"237",637,"IP SUR COLON/RECTAL/SMALL BOWEL RESECTION POSTOP",5576,"102","ACETAMINOPHEN 500 MG PO TABS",2,396,0.0710186513629842,392,15968,0.00505050505050505,0.0245490981963928,0.205730777159349,394,15576,0.0195679878212455
"238",637,"IP SUR COLON/RECTAL/SMALL BOWEL RESECTION POSTOP",5576,"3843","IBUPROFEN 400 MG PO TABS",1,5,0.000896700143472023,148,4216,0.2,0.0351043643263757,5.6972972972973,4,4068,0.432774211971368
"239",637,"IP SUR COLON/RECTAL/SMALL BOWEL RESECTION POSTOP",5576,"5002","METOCLOPRAMIDE HCL 5 MG/ML INJ SOLN",10,1652,0.296269727403156,346,10128,0.00605326876513317,0.0341627172195893,0.177189323853378,1642,9782,9.92519223695702e-10
"240",637,"IP SUR COLON/RECTAL/SMALL BOWEL RESECTION POSTOP",5576,"14087","ACETAMINOPHEN-CODEINE 300-30 MG PO TABS",1,36,0.00645624103299857,28,1655,0.0277777777777778,0.0169184290030211,1.64186507936508,35,1627,0.999999999999962
"241",637,"IP SUR COLON/RECTAL/SMALL BOWEL RESECTION POSTOP",5576,"14863","POTASSIUM CHLORID-D5-0.45%NACL 20 MEQ/L IV SOLP",7,1544,0.276901004304161,314,8762,0.00453367875647668,0.035836566993837,0.126509851160028,1537,8448,1.12382923833331e-10
"242",637,"IP SUR COLON/RECTAL/SMALL BOWEL RESECTION POSTOP",5576,"18308","GABAPENTIN 300 MG PO CAPS",6,1093,0.196018651362984,588,19458,0.00548947849954254,0.0302189330866482,0.181656926265474,1087,18870,3.22960346992825e-06
"243",637,"IP SUR COLON/RECTAL/SMALL BOWEL RESECTION POSTOP",5576,"22473","KETOROLAC 30 MG/ML (1 ML) INJ SOLN",2,679,0.121771879483501,132,2852,0.00294550810014728,0.0462833099579243,0.0636408265274245,677,2720,1.99440115014707e-07
"244",637,"IP SUR COLON/RECTAL/SMALL BOWEL RESECTION POSTOP",5576,"82384","PANTOPRAZOLE 40 MG IV SOLR",1,152,0.0272596843615495,688,12925,0.00657894736842105,0.0532301740812379,0.12359432374541,151,12237,0.0174616132912249
"245",637,"IP SUR COLON/RECTAL/SMALL BOWEL RESECTION POSTOP",5576,"87475","PIPERACILLIN-TAZOBACTAM 3.375 GRAM IV SOLR",4,8,0.00143472022955524,49,686,0.5,0.0714285714285714,7,4,637,0.000109596921679685
"246",637,"IP SUR COLON/RECTAL/SMALL BOWEL RESECTION POSTOP",5576,"96559","PIPERACILLIN-TAZOBACTAM-DEXTRS 3.375 GRAM/50 ML IV PGBK",2,32,0.00573888091822095,1067,10067,0.0625,0.105989867885169,0.58967900656045,30,9000,0.609604110338662
"247",637,"IP SUR COLON/RECTAL/SMALL BOWEL RESECTION POSTOP",5576,"110888","ENOXAPARIN 30 MG/0.3 ML SC SYRG",1,22,0.0039454806312769,73,1394,0.0454545454545455,0.0523672883787661,0.86799501867995,21,1321,0.999999999999997
"248",637,"IP SUR COLON/RECTAL/SMALL BOWEL RESECTION POSTOP",5576,"110892","ENOXAPARIN 40 MG/0.4 ML SC SYRG",9,1179,0.211441893830703,499,13896,0.00763358778625954,0.0359096142774899,0.212577827410546,1170,13397,3.74105792003645e-07
"249",637,"IP SUR COLON/RECTAL/SMALL BOWEL RESECTION POSTOP",5576,"112586","HYDROMORPHONE 1 MG/ML INJ SYRG",1,105,0.0188307030129125,1219,33427,0.00952380952380952,0.036467526251234,0.261158639009336,104,32208,0.225819358848272
"250",637,"IP SUR COLON/RECTAL/SMALL BOWEL RESECTION POSTOP",5576,"198509","ONDANSETRON HCL (PF) 4 MG/2 ML INJ SOLN",13,1759,0.315459110473458,705,36939,0.00739056281978397,0.0190855193697718,0.387234042553191,1746,36234,0.000538564735518951
"251",637,"IP SUR COLON/RECTAL/SMALL BOWEL RESECTION POSTOP",5576,"205597","ALVIMOPAN 12 MG PO CAPS",3,979,0.175573888091822,28,1117,0.00306435137895812,0.0250671441360788,0.122245731796294,976,1089,6.83145425217705e-05
"252",637,"IP SUR COLON/RECTAL/SMALL BOWEL RESECTION POSTOP",5576,"210379","HYDROCORTISONE SOD SUCC (PF) 100 MG/2 ML INJ SOLR",10,420,0.0753228120516499,313,9164,0.0238095238095238,0.0341553906591008,0.697094173132512,410,8851,0.312194477640444
"253",637,"IP SUR COLON/RECTAL/SMALL BOWEL RESECTION POSTOP",5576,"212629","ACETAMINOPHEN 1,000 MG/100 ML (10 MG/ML) IV SOLN",1,613,0.10993543758967,510,18335,0.00163132137030995,0.0278156531224434,0.0586476025973195,612,17825,0.000138954725962682
"254",637,"IP SUR COLON/RECTAL/SMALL BOWEL RESECTION POSTOP",5576,"212945","HEPARIN, PORCINE (PF) 5,000 UNIT/0.5 ML INJ SOLN",8,379,0.0679698708751793,452,13480,0.0211081794195251,0.0335311572700297,0.629509421626544,371,13028,0.235572820981245
"255",639,"IP SUR COLECTOMY PREOP",37,"110892","ENOXAPARIN 40 MG/0.4 ML SC SYRG",1,1,0.027027027027027,499,13896,1,0.0359096142774899,27.8476953907816,0,13397,0.0127154320473097
"256",647,"IP SUR CHOLECYSTECTOMY POSTOP",123,"5002","METOCLOPRAMIDE HCL 5 MG/ML INJ SOLN",1,39,0.317073170731707,346,10128,0.0256410256410256,0.0341627172195893,0.750555802578924,38,9782,0.999999999999992
"257",647,"IP SUR CHOLECYSTECTOMY POSTOP",123,"5940","OXYCODONE-ACETAMINOPHEN 5-325 MG PO TABS",1,4,0.032520325203252,218,7862,0.25,0.0277283134062579,9.01605504587156,3,7644,0.237431625195555
"258",647,"IP SUR CHOLECYSTECTOMY POSTOP",123,"198509","ONDANSETRON HCL (PF) 4 MG/2 ML INJ SOLN",1,46,0.373983739837398,705,36939,0.0217391304347826,0.0190855193697718,1.13903792784459,45,36234,0.999999999999958
"259",663,"IP GU GENERAL ADMIT",522,"472","AMPICILLIN SODIUM 2 GRAM INJ SOLR",2,2,0.00383141762452107,2,32,1,0.0625,16,0,30,0.00422224166133054
"260",663,"IP GU GENERAL ADMIT",522,"1445","CEFAZOLIN 1 GRAM INJ SOLR",14,33,0.0632183908045977,47,571,0.424242424242424,0.0823117338003503,5.15409413281754,19,524,1.53044826066995e-09
"261",663,"IP GU GENERAL ADMIT",522,"2566","DOCUSATE SODIUM 100 MG PO CAPS",2,78,0.149425287356322,542,37509,0.0256410256410256,0.0144498653656456,1.77448197558899,76,36967,0.724694712809625
"262",663,"IP GU GENERAL ADMIT",522,"5940","OXYCODONE-ACETAMINOPHEN 5-325 MG PO TABS",3,14,0.0268199233716475,218,7862,0.214285714285714,0.0277283134062579,7.72804718217562,11,7644,0.000642135617261398
"263",663,"IP GU GENERAL ADMIT",522,"8442","VANCOMYCIN 1,000 MG IV SOLR",3,5,0.00957854406130268,248,2879,0.6,0.0861410211879125,6.96532258064516,2,2631,0.00104259691406982
"264",663,"IP GU GENERAL ADMIT",522,"16426","NS WITH POTASSIUM CHLORIDE 20 MEQ/L IV SOLP",1,14,0.0268199233716475,118,4415,0.0714285714285714,0.026727066817667,2.6725181598063,13,4297,0.83755954003275
"265",663,"IP GU GENERAL ADMIT",522,"81505","CIPROFLOXACIN IN D5W 400 MG/200 ML IV PGBK",1,13,0.024904214559387,242,3682,0.0769230769230769,0.0657251493753395,1.17037507946599,12,3440,0.999999999999852
"266",663,"IP GU GENERAL ADMIT",522,"110872","HYDROMORPHONE 2 MG/ML INJ SYRG",3,81,0.155172413793103,738,23934,0.037037037037037,0.0308347956881424,1.20114423366456,78,23196,0.999647165929283
"267",663,"IP GU GENERAL ADMIT",522,"198509","ONDANSETRON HCL (PF) 4 MG/2 ML INJ SOLN",1,162,0.310344827586207,705,36939,0.00617283950617284,0.0190855193697718,0.323430522721303,161,36234,0.36169749511122
"268",669,"IP GU RADICAL CYSTECTOMY POSTOP",2684,"101","ACETAMINOPHEN 325 MG PO TABS",1,374,0.139344262295082,981,42092,0.00267379679144385,0.0233060914187969,0.114725233991289,373,41111,0.0135006738522522
"269",669,"IP GU RADICAL CYSTECTOMY POSTOP",2684,"2508","DIPHENHYDRAMINE HCL 50 MG/ML INJ SOLN",2,46,0.0171385991058122,399,16019,0.0434782608695652,0.0249079218428117,1.74555955105154,44,15620,0.739169168530361
"270",669,"IP GU RADICAL CYSTECTOMY POSTOP",2684,"3758","HYDROMORPHONE 2 MG/ML INJ SOLN",1,2,0.000745156482861401,2,86,0.5,0.0232558139534884,21.5,1,84,0.0887325490861772
"271",669,"IP GU RADICAL CYSTECTOMY POSTOP",2684,"5002","METOCLOPRAMIDE HCL 5 MG/ML INJ SOLN",9,992,0.369597615499255,346,10128,0.00907258064516129,0.0341627172195893,0.265569643856051,983,9782,2.7247982488948e-05
"272",669,"IP GU RADICAL CYSTECTOMY POSTOP",2684,"10814","OXYCODONE 5 MG PO TABS",1,100,0.03725782414307,1478,56614,0.01,0.0261066167379094,0.383044654939107,99,55136,0.486586525277349
"273",669,"IP GU RADICAL CYSTECTOMY POSTOP",2684,"16426","NS WITH POTASSIUM CHLORIDE 20 MEQ/L IV SOLP",2,19,0.00707898658718331,118,4415,0.105263157894737,0.026727066817667,3.93844781445138,17,4297,0.162501221072004
"274",669,"IP GU RADICAL CYSTECTOMY POSTOP",2684,"22472","KETOROLAC 15 MG/ML INJ SOLN",1,275,0.102459016393443,215,5031,0.00363636363636364,0.0427350427350427,0.0850909090909091,274,4816,0.00238010343936673
"275",669,"IP GU RADICAL CYSTECTOMY POSTOP",2684,"25365","CEFAZOLIN IN DEXTROSE (ISO-OS) 1 GRAM/50 ML IV PGBK",2,322,0.119970193740686,258,5335,0.0062111801242236,0.0483598875351453,0.128436612258655,320,5077,0.000750117305920331
"276",669,"IP GU RADICAL CYSTECTOMY POSTOP",2684,"27838","SODIUM CHLORIDE 0.9 % 0.9 % IV SOLP",5,648,0.241430700447094,692,19620,0.00771604938271605,0.0352701325178389,0.218770070648683,643,18928,0.00023549829143579
"277",669,"IP GU RADICAL CYSTECTOMY POSTOP",2684,"82384","PANTOPRAZOLE 40 MG IV SOLR",4,141,0.0525335320417288,688,12925,0.0283687943262411,0.0532301740812379,0.532945736434108,137,12237,0.261865360486221
"278",669,"IP GU RADICAL CYSTECTOMY POSTOP",2684,"110872","HYDROMORPHONE 2 MG/ML INJ SYRG",5,294,0.109538002980626,738,23934,0.0170068027210884,0.0308347956881424,0.551545821580665,289,23196,0.231444011120535
"279",669,"IP GU RADICAL CYSTECTOMY POSTOP",2684,"112586","HYDROMORPHONE 1 MG/ML INJ SYRG",2,273,0.101713859910581,1219,33427,0.00732600732600733,0.036467526251234,0.200891260776413,271,32208,0.0162326432461977
"280",669,"IP GU RADICAL CYSTECTOMY POSTOP",2684,"198509","ONDANSETRON HCL (PF) 4 MG/2 ML INJ SOLN",9,990,0.368852459016393,705,36939,0.00909090909090909,0.0190855193697718,0.476324951644101,981,36234,0.0303853978232914
"281",669,"IP GU RADICAL CYSTECTOMY POSTOP",2684,"200439","HYDROMORPHONE (PF) 2 MG/ML INJ SOLN",1,31,0.0115499254843517,142,3356,0.032258064516129,0.0423122765196663,0.762380736029078,30,3214,0.999999999999999
"282",669,"IP GU RADICAL CYSTECTOMY POSTOP",2684,"212945","HEPARIN, PORCINE (PF) 5,000 UNIT/0.5 ML INJ SOLN",4,909,0.338673621460507,452,13480,0.0044004400440044,0.0335311572700297,0.131234362374291,905,13028,1.98497760007842e-06
"283",669,"IP GU RADICAL CYSTECTOMY POSTOP",2684,"236263","CEFAZOLIN IN DEXTROSE (ISO-OS) 2 GRAM/100 ML IV PGBK",2,132,0.0491803278688525,111,2584,0.0151515151515152,0.0429566563467492,0.352716352716353,130,2473,0.181221865606894
"284",669,"IP GU RADICAL CYSTECTOMY POSTOP",2684,"520064","CEFAZOLIN 2 G IVPB",1,143,0.0532786885245902,109,2674,0.00699300699300699,0.0407629020194465,0.171553217424777,142,2565,0.0703646985060621
"285",669,"IP GU RADICAL CYSTECTOMY POSTOP",2684,"541048","HYDROMORPHONE VARIABLE DOSE INJECTION",1,66,0.0245901639344262,104,5739,0.0151515151515152,0.0181216239763025,0.836101398601399,65,5635,0.999999999999998
"286",669,"IP GU RADICAL CYSTECTOMY POSTOP",2684,"541104","CEFOXITIN 1 GRAM/50 ML MINI-BAG PLUS",1,129,0.0480625931445604,9,214,0.00775193798449612,0.0420560747663551,0.184323858742463,128,205,0.134139353198699
"287",672,"IP GU RADICAL PROSTATECTOMY POSTOP",1059,"101","ACETAMINOPHEN 325 MG PO TABS",1,333,0.314447592067989,981,42092,0.003003003003003,0.0233060914187969,0.128850563101328,332,41111,0.0231297659363506
"288",672,"IP GU RADICAL PROSTATECTOMY POSTOP",1059,"22473","KETOROLAC 30 MG/ML (1 ML) INJ SOLN",1,175,0.165250236071766,132,2852,0.00571428571428571,0.0462833099579243,0.123463203463203,174,2720,0.0186885122964422
"289",672,"IP GU RADICAL PROSTATECTOMY POSTOP",1059,"82384","PANTOPRAZOLE 40 MG IV SOLR",6,130,0.12275731822474,688,12925,0.0461538461538462,0.0532301740812379,0.867061717352415,124,12237,0.871790447504682
"290",679,"IP GU TURP/TURBT POSTOP",281,"101","ACETAMINOPHEN 325 MG PO TABS",3,56,0.199288256227758,981,42092,0.0535714285714286,0.0233060914187969,2.29860200961118,53,41111,0.290914041510297
"291",679,"IP GU TURP/TURBT POSTOP",281,"5007","METOPROLOL TARTRATE 5 MG/5 ML IV SOLN",1,8,0.0284697508896797,745,12385,0.125,0.0601534113847396,2.07802013422819,7,11640,0.978127892210357
"292",679,"IP GU TURP/TURBT POSTOP",281,"110892","ENOXAPARIN 40 MG/0.4 ML SC SYRG",1,2,0.00711743772241993,499,13896,0.5,0.0359096142774899,13.9238476953908,1,13397,0.10408135842914
"293",679,"IP GU TURP/TURBT POSTOP",281,"198509","ONDANSETRON HCL (PF) 4 MG/2 ML INJ SOLN",1,117,0.416370106761566,705,36939,0.00854700854700855,0.0190855193697718,0.447826877614112,116,36234,0.621414245141014
"294",679,"IP GU TURP/TURBT POSTOP",281,"236263","CEFAZOLIN IN DEXTROSE (ISO-OS) 2 GRAM/100 ML IV PGBK",1,5,0.0177935943060498,111,2584,0.2,0.0429566563467492,4.65585585585586,4,2473,0.532467187505868
"295",684,"IP GU NEPHRECTOMY POSTOP",154,"2566","DOCUSATE SODIUM 100 MG PO CAPS",2,34,0.220779220779221,542,37509,0.0588235294117647,0.0144498653656456,4.0708704145865,32,36967,0.148084901231214
"296",684,"IP GU NEPHRECTOMY POSTOP",154,"2567","DOCUSATE SODIUM 250 MG PO CAPS",1,27,0.175324675324675,296,17760,0.037037037037037,0.0166666666666667,2.22222222222222,26,17464,0.941091277901481
"297",691,"IP MED UTI/PYELONEPHRITIS",63,"115288","LEVOFLOXACIN IN D5W 750 MG/150 ML IV PGBK",1,2,0.0317460317460317,208,3699,0.5,0.0562314138956475,8.89182692307692,1,3491,0.235620077804616
"298",692,"IP MED SEPSIS",81,"88175","OSELTAMIVIR 75 MG PO CAPS",1,3,0.037037037037037,41,1269,0.333333333333333,0.0323089046493302,10.3170731707317,2,1228,0.194625929450645
"299",692,"IP MED SEPSIS",81,"88533","AZTREONAM 2 GRAM INJ SOLR",1,1,0.0123456790123457,17,47,1,0.361702127659574,2.76470588235294,0,30,0.794145541405665
"300",692,"IP MED SEPSIS",81,"96560","PIPERACILLIN-TAZOBACTAM-DEXTRS 4.5 GRAM/100 ML IV PGBK",1,2,0.0246913580246914,290,2601,0.5,0.111495578623606,4.48448275862069,1,2311,0.534928171423576
"301",692,"IP MED SEPSIS",81,"540965","PIPERACILLIN-TAZOBACTAM 3.375 GRAM/50 ML MINI-BAG PLUS",1,2,0.0246913580246914,235,4195,0.5,0.0560190703218117,8.92553191489362,1,3960,0.234114040528826
"302",693,"IP MED PANCREATITIS (ACUTE)",95,"101","ACETAMINOPHEN 325 MG PO TABS",1,14,0.147368421052632,981,42092,0.0714285714285714,0.0233060914187969,3.06480267948158,13,41111,0.758635264760877
"303",693,"IP MED PANCREATITIS (ACUTE)",95,"16426","NS WITH POTASSIUM CHLORIDE 20 MEQ/L IV SOLP",1,6,0.0631578947368421,118,4415,0.166666666666667,0.026727066817667,6.23587570621469,5,4297,0.392854981090241
"304",697,"IP MED GI BLEED UPPER",307,"14863","POTASSIUM CHLORID-D5-0.45%NACL 20 MEQ/L IV SOLP",2,5,0.0162866449511401,314,8762,0.4,0.035836566993837,11.1617834394904,3,8448,0.00153845256023476
"305",697,"IP MED GI BLEED UPPER",307,"15861","D5 %-0.45 % SODIUM CHLORIDE IV SOLP",1,6,0.0195439739413681,158,4300,0.166666666666667,0.0367441860465116,4.53586497890295,5,4142,0.546357696621898
"306",697,"IP MED GI BLEED UPPER",307,"25122","OCTREOTIDE ACETATE 100 MCG/ML INJ SOLN",2,22,0.0716612377850163,62,895,0.0909090909090909,0.0692737430167598,1.31231671554252,20,833,0.999999999999975
"307",697,"IP MED GI BLEED UPPER",307,"27838","SODIUM CHLORIDE 0.9 % 0.9 % IV SOLP",1,15,0.0488599348534202,692,19620,0.0666666666666667,0.0352701325178389,1.89017341040462,14,18928,0.999999999999522
"308",697,"IP MED GI BLEED UPPER",307,"81505","CIPROFLOXACIN IN D5W 400 MG/200 ML IV PGBK",1,8,0.0260586319218241,242,3682,0.125,0.0657251493753395,1.90185950413223,7,3440,0.999999999999995
"309",697,"IP MED GI BLEED UPPER",307,"82384","PANTOPRAZOLE 40 MG IV SOLR",6,51,0.166123778501629,688,12925,0.117647058823529,0.0532301740812379,2.21015731874145,45,12237,0.0838450749163841
"310",697,"IP MED GI BLEED UPPER",307,"530014","PANTOPRAZOLE 0.8 MG/ML IV INFUSION",5,54,0.175895765472313,72,1751,0.0925925925925926,0.0411193603655054,2.25180041152263,49,1679,0.133186522251737
"311",698,"IP MED GENERAL ADMIT",71055,"101","ACETAMINOPHEN 325 MG PO TABS",209,16668,0.234578847371754,981,42092,0.0125389968802496,0.0233060914187969,0.538013717312401,16459,41111,8.80538535241591e-17
"312",698,"IP MED GENERAL ADMIT",71055,"102","ACETAMINOPHEN 500 MG PO TABS",18,850,0.0119625642108226,392,15968,0.0211764705882353,0.0245490981963928,0.862617046818727,832,15576,0.612062274003116
"313",698,"IP MED GENERAL ADMIT",71055,"1080","BISACODYL 10 MG PR SUPP",33,4037,0.0568151431989304,344,22442,0.00817438692098093,0.0153284021031994,0.533283695583296,4004,22098,0.000539951572324925
"314",698,"IP MED GENERAL ADMIT",71055,"2566","DOCUSATE SODIUM 100 MG PO CAPS",141,11489,0.16169164731546,542,37509,0.012272608582122,0.0144498653656456,0.849323386174936,11348,36967,0.0898562830961058
"315",698,"IP MED GENERAL ADMIT",71055,"2567","DOCUSATE SODIUM 250 MG PO CAPS",6,529,0.00744493702061783,296,17760,0.0113421550094518,0.0166666666666667,0.680529300567108,523,17464,0.439007262424072
"316",698,"IP MED GENERAL ADMIT",71055,"3843","IBUPROFEN 400 MG PO TABS",10,316,0.00444725916543523,148,4216,0.0316455696202532,0.0351043643263757,0.901471091344509,306,4068,0.869485301897334
"317",698,"IP MED GENERAL ADMIT",71055,"5002","METOCLOPRAMIDE HCL 5 MG/ML INJ SOLN",15,873,0.0122862571247625,346,10128,0.0171821305841924,0.0341627172195893,0.502949764614743,858,9782,0.00923644044140893
"318",698,"IP MED GENERAL ADMIT",71055,"5005","METOCLOPRAMIDE HCL 10 MG PO TABS",8,196,0.00275842657096615,127,2872,0.0408163265306122,0.0442200557103064,0.923027478708019,188,2745,0.964252756038656
"319",698,"IP MED GENERAL ADMIT",71055,"5373","NALOXONE 0.4 MG/ML INJ SOLN",2,428,0.00602350292027303,83,1774,0.00467289719626168,0.0467869222096956,0.0998761400743159,426,1691,8.86784842492836e-05
"320",698,"IP MED GENERAL ADMIT",71055,"6582","PROCHLORPERAZINE MALEATE 10 MG PO TABS",1,85,0.00119625642108226,56,5593,0.0117647058823529,0.0100125156445557,1.175,84,5537,0.999999999999994
"321",698,"IP MED GENERAL ADMIT",71055,"6583","PROCHLORPERAZINE MALEATE 5 MG PO TABS",2,304,0.00427837590598832,18,681,0.00657894736842105,0.026431718061674,0.24890350877193,302,663,0.0724739191978432
"322",698,"IP MED GENERAL ADMIT",71055,"6618","PROMETHAZINE 25 MG/ML INJ SOLN",11,619,0.00871156146646964,289,5149,0.0177705977382876,0.056127403379297,0.316611791537864,608,4860,7.34642357462109e-05
"323",698,"IP MED GENERAL ADMIT",71055,"8085","TRAZODONE 50 MG PO TABS",16,1865,0.0262472732390402,334,11344,0.00857908847184987,0.0294428772919605,0.291380777319356,1849,11010,3.03709111058037e-07
"324",698,"IP MED GENERAL ADMIT",71055,"8750","WARFARIN 2.5 MG PO TABS",1,1,1.40736049539089e-05,86,3039,1,0.0282987824942415,35.3372093023256,0,2953,0.00468904412440495
"325",698,"IP MED GENERAL ADMIT",71055,"11138","PROCHLORPERAZINE 25 MG PR SUPP",1,52,0.000731827457603265,6,140,0.0192307692307692,0.0428571428571429,0.448717948717949,51,134,0.73161657388473
"326",698,"IP MED GENERAL ADMIT",71055,"11349","SENNOSIDES 8.6 MG PO TABS",9,444,0.00624868059953557,610,35793,0.0202702702702703,0.0170424384656218,1.18939964554719,435,35183,0.735805334371769
"327",698,"IP MED GENERAL ADMIT",71055,"11664","WARFARIN 1 MG PO TABS",5,13,0.000182956864400816,98,3895,0.384615384615385,0.0251604621309371,15.2864992150706,8,3797,5.59938914247756e-13
"328",698,"IP MED GENERAL ADMIT",71055,"14632","TRAMADOL 50 MG PO TABS",23,1795,0.0252621208922666,304,13808,0.0128133704735376,0.0220162224797219,0.581996774666471,1772,13504,0.0133968611588831
"329",698,"IP MED GENERAL ADMIT",71055,"14858","D5-NS WITH POTASSIUM CHLORIDE 20 MEQ/L IV SOLP",12,339,0.00477095207937513,58,2031,0.0353982300884956,0.0285573609059577,1.23954836740922,327,1973,0.606256011765557
"330",698,"IP MED GENERAL ADMIT",71055,"14863","POTASSIUM CHLORID-D5-0.45%NACL 20 MEQ/L IV SOLP",8,601,0.00845823657729928,314,8762,0.0133111480865225,0.035836566993837,0.371440380681878,593,8448,0.00486622789172391
"331",698,"IP MED GENERAL ADMIT",71055,"15861","D5 %-0.45 % SODIUM CHLORIDE IV SOLP",20,500,0.00703680247695447,158,4300,0.04,0.0367441860465116,1.08860759493671,480,4142,0.810620074050711
"332",698,"IP MED GENERAL ADMIT",71055,"16426","NS WITH POTASSIUM CHLORIDE 20 MEQ/L IV SOLP",12,613,0.00862711983674618,118,4415,0.0195758564437194,0.026727066817667,0.732435645754417,601,4297,0.363019562630004
"333",698,"IP MED GENERAL ADMIT",71055,"20943","AZITHROMYCIN 250 MG PO TABS",1,31,0.000436281753571177,132,3557,0.032258064516129,0.0371099240933371,0.869257086999022,30,3425,0.999999999999998
"334",698,"IP MED GENERAL ADMIT",71055,"25424","POLYETHYLENE GLYCOL 3350 17 GRAM PO PWPK",79,10366,0.14588698895222,712,36910,0.00762106887902759,0.0192901652668653,0.395075354388916,10287,36198,3.91580181706609e-16
"335",698,"IP MED GENERAL ADMIT",71055,"27838","SODIUM CHLORIDE 0.9 % 0.9 % IV SOLP",75,3203,0.0450777566673704,692,19620,0.0234155479238214,0.0352701325178389,0.663891691134937,3128,18928,0.000676627642620302
"336",698,"IP MED GENERAL ADMIT",71055,"34505","HYDROCODONE-ACETAMINOPHEN 5-325 MG PO TABS",46,2580,0.0363099007810851,603,24164,0.0178294573643411,0.0249544777354743,0.71447928317071,2534,23561,0.0301364625138016
"337",698,"IP MED GENERAL ADMIT",71055,"80840","ONDANSETRON HCL 8 MG PO TABS",3,182,0.00256139610161143,170,10077,0.0164835164835165,0.0168701002282425,0.977084680025857,179,9907,0.999999999999991
"338",698,"IP MED GENERAL ADMIT",71055,"80845","ONDANSETRON HCL 2 MG/ML IV SOLN",1,11,0.000154809654492998,1,52,0.0909090909090909,0.0192307692307692,4.72727272727273,10,51,0.775306503342273
"339",698,"IP MED GENERAL ADMIT",71055,"81141","ONDANSETRON HCL 4 MG PO TABS",32,3443,0.0484554218563085,87,4024,0.00929422015683997,0.0216202783300199,0.429884389783035,3411,3937,3.36822571528808e-05
"340",698,"IP MED GENERAL ADMIT",71055,"84520","ONDANSETRON 8 MG PO TBDL",7,90,0.0012666244458518,153,4394,0.0777777777777778,0.0348202093764224,2.23369644153958,83,4241,0.0590545946041133
"341",698,"IP MED GENERAL ADMIT",71055,"86533","MAGNESIUM HYDROXIDE 400 MG/5 ML PO SUSP",9,1834,0.025810991485469,111,6618,0.00490730643402399,0.0167724388032638,0.292581567390728,1825,6507,0.000225088628344927
"342",698,"IP MED GENERAL ADMIT",71055,"92173","ZOLPIDEM 5 MG PO TABS",7,944,0.01328548307649,159,8203,0.00741525423728814,0.019383152505181,0.382561827097324,937,8044,0.0131419805287129
"343",698,"IP MED GENERAL ADMIT",71055,"93263","LEVOFLOXACIN 750 MG PO TABS",1,10,0.000140736049539089,172,3978,0.1,0.0432378079436903,2.31279069767442,9,3806,0.91804921723451
"344",698,"IP MED GENERAL ADMIT",71055,"94176","ONDANSETRON 4 MG PO TBDL",9,1080,0.0151994933502217,153,4277,0.00833333333333333,0.0357727379003975,0.232952069716776,1071,4124,4.11187065968056e-06
"345",698,"IP MED GENERAL ADMIT",71055,"96559","PIPERACILLIN-TAZOBACTAM-DEXTRS 3.375 GRAM/50 ML IV PGBK",10,35,0.000492576173386813,1067,10067,0.285714285714286,0.105989867885169,2.69567545856206,25,9000,0.00155124580503254
"346",698,"IP MED GENERAL ADMIT",71055,"110872","HYDROMORPHONE 2 MG/ML INJ SYRG",44,1315,0.0185067905143903,738,23934,0.0334600760456274,0.0308347956881424,1.08514018980494,1271,23196,0.650348167299227
"347",698,"IP MED GENERAL ADMIT",71055,"110888","ENOXAPARIN 30 MG/0.3 ML SC SYRG",27,390,0.00548870593202449,73,1394,0.0692307692307692,0.0523672883787661,1.32202318229715,363,1321,0.247980228530301
"348",698,"IP MED GENERAL ADMIT",71055,"110890","ENOXAPARIN 80 MG/0.8 ML SC SYRG",1,14,0.000197030469354725,147,2839,0.0714285714285714,0.0517787953504755,1.37949465500486,13,2692,0.999999999999815
"349",698,"IP MED GENERAL ADMIT",71055,"110892","ENOXAPARIN 40 MG/0.4 ML SC SYRG",288,6215,0.0874674547885441,499,13896,0.0463395012067578,0.0359096142774899,1.29044831416655,5927,13397,0.000491431847521699
"350",698,"IP MED GENERAL ADMIT",71055,"112564","MORPHINE 2 MG/ML INJ SYRG",31,1669,0.023488846668074,276,6156,0.018573996405033,0.0448343079922027,0.414280876338344,1638,5880,1.36470473882025e-06
"351",698,"IP MED GENERAL ADMIT",71055,"112586","HYDROMORPHONE 1 MG/ML INJ SYRG",35,941,0.0132432622616283,1219,33427,0.0371944739638682,0.036467526251234,1.01993411090256,906,32208,0.976748079314111
"352",698,"IP MED GENERAL ADMIT",71055,"115288","LEVOFLOXACIN IN D5W 750 MG/150 ML IV PGBK",1,48,0.000675533037787629,208,3699,0.0208333333333333,0.0562314138956475,0.370492788461538,47,3491,0.456108877367217
"353",698,"IP MED GENERAL ADMIT",71055,"198509","ONDANSETRON HCL (PF) 4 MG/2 ML INJ SOLN",148,15022,0.21141369361762,705,36939,0.00985221674876847,0.0190855193697718,0.516214233308878,14874,36234,7.96215580813808e-14
"354",698,"IP MED GENERAL ADMIT",71055,"200439","HYDROMORPHONE (PF) 2 MG/ML INJ SOLN",22,450,0.00633312222925903,142,3356,0.0488888888888889,0.0423122765196663,1.1554303599374,428,3214,0.601991401344729
"355",698,"IP MED GENERAL ADMIT",71055,"209037","ACETAMINOPHEN 650 MG/20.3 ML PO SOLN",4,58,0.000816269087326719,192,8611,0.0689655172413793,0.0222970618975729,3.0930316091954,54,8419,0.0524107520025368
"356",698,"IP MED GENERAL ADMIT",71055,"212945","HEPARIN, PORCINE (PF) 5,000 UNIT/0.5 ML INJ SOLN",185,7145,0.100555907395679,452,13480,0.0258922323303009,0.0335311572700297,0.772184273921363,6960,13028,0.00292965162423249
"357",698,"IP MED GENERAL ADMIT",71055,"221636","PROCHLORPERAZINE EDISYLATE 10 MG/2 ML (5 MG/ML) INJ SOLN",3,100,0.00140736049539089,177,6874,0.03,0.0257491998836194,1.16508474576271,97,6697,0.999999999999925
"358",698,"IP MED GENERAL ADMIT",71055,"222272","LACTULOSE 20 GRAM/30 ML PO SOLN",5,188,0.00264583773133488,398,10561,0.0265957446808511,0.0376858252059464,0.70572276274992,183,10163,0.548659676692611
"359",698,"IP MED GENERAL ADMIT",71055,"520039","AZITHROMYCIN IVPB",2,35,0.000492576173386813,127,2522,0.0571428571428571,0.0503568596352102,1.1347581552306,33,2395,0.999999999999994
"360",698,"IP MED GENERAL ADMIT",71055,"520046","VANCOMYCIN IVPB (CUSTOM DOSE)",14,86,0.00121033002603617,1808,23328,0.162790697674419,0.0775034293552812,2.10043218769294,72,21520,0.00604328522983912
"361",698,"IP MED GENERAL ADMIT",71055,"540493","WARFARIN PER PHARMACY PROTOCOL",1,100,0.00140736049539089,218,6316,0.01,0.0345155161494617,0.289724770642202,99,6098,0.288201632816547
"362",698,"IP MED GENERAL ADMIT",71055,"540769","SODIUM CHLORIDE 3 % IV BOLUS",1,7,9.85152346773626e-05,71,876,0.142857142857143,0.0810502283105023,1.7625754527163,6,805,0.999999999999994
"363",698,"IP MED GENERAL ADMIT",71055,"540967","PIPERACILLIN-TAZOBACTAM 4.5 GRAM/100 ML MINI-BAG PLUS",3,32,0.000450355358525086,135,2073,0.09375,0.065123010130246,1.43958333333333,29,1938,0.772255856388379
"364",698,"IP MED GENERAL ADMIT",71055,"541048","HYDROMORPHONE VARIABLE DOSE INJECTION",7,210,0.00295545704032088,104,5739,0.0333333333333333,0.0181216239763025,1.83942307692308,203,5635,0.180100219681251
"365",698,"IP MED GENERAL ADMIT",71055,"541085","CEFTRIAXONE 1 GRAM/50 ML MINI-BAG PLUS",3,56,0.000788121877418901,411,7130,0.0535714285714286,0.0576437587657784,0.929353493222106,53,6719,0.999999999999857
"366",704,"IP MED COPD",216,"78668","IPRATROPIUM-ALBUTEROL 0.5 MG-3 MG(2.5 MG BASE)/3 ML INH NEBU",4,68,0.314814814814815,493,18456,0.0588235294117647,0.0267121803207629,2.20212385156903,64,17963,0.207745350642925
"367",704,"IP MED COPD",216,"96559","PIPERACILLIN-TAZOBACTAM-DEXTRS 3.375 GRAM/50 ML IV PGBK",2,2,0.00925925925925926,1067,10067,1,0.105989867885169,9.4348641049672,0,9000,0.00311637347350603
"368",704,"IP MED COPD",216,"541109","DOXYCYCLINE 100 MG/100 ML MINI-BAG PLUS",2,4,0.0185185185185185,13,330,0.5,0.0393939393939394,12.6923076923077,2,317,0.00134178901939379
"369",704,"IP MED COPD",216,"541271","PIPERACILLIN-TAZOBACTAM 3.375 GRAM/50 ML IVPB EXTENDED INFUSION",1,2,0.00925925925925926,466,8270,0.5,0.0563482466747279,8.87339055793991,1,7804,0.235590749930388
"370",704,"IP MED COPD",216,"9000000","ZZZ IMS TEMPLATE",1,33,0.152777777777778,1035,28824,0.0303030303030303,0.0359075770191507,0.843917435221783,32,27789,0.999999999998816
"371",705,"IP MED COMMUNITY ACQUIRED PNEUMONIA",192,"93263","LEVOFLOXACIN 750 MG PO TABS",2,9,0.046875,172,3978,0.222222222222222,0.0432378079436903,5.13953488372093,7,3806,0.0705128825964503
"372",705,"IP MED COMMUNITY ACQUIRED PNEUMONIA",192,"96559","PIPERACILLIN-TAZOBACTAM-DEXTRS 3.375 GRAM/50 ML IV PGBK",4,12,0.0625,1067,10067,0.333333333333333,0.105989867885169,3.14495470165573,8,9000,0.0370362557208241
"373",705,"IP MED COMMUNITY ACQUIRED PNEUMONIA",192,"96560","PIPERACILLIN-TAZOBACTAM-DEXTRS 4.5 GRAM/100 ML IV PGBK",1,3,0.015625,290,2601,0.333333333333333,0.111495578623606,2.98965517241379,2,2311,0.762596011988471
"374",705,"IP MED COMMUNITY ACQUIRED PNEUMONIA",192,"115288","LEVOFLOXACIN IN D5W 750 MG/150 ML IV PGBK",2,23,0.119791666666667,208,3699,0.0869565217391304,0.0562314138956475,1.54640468227425,21,3491,0.854487209222801
"375",705,"IP MED COMMUNITY ACQUIRED PNEUMONIA",192,"520039","AZITHROMYCIN IVPB",2,22,0.114583333333333,127,2522,0.0909090909090909,0.0503568596352102,1.80529706513958,20,2395,0.707513481329213
"376",705,"IP MED COMMUNITY ACQUIRED PNEUMONIA",192,"520046","VANCOMYCIN IVPB (CUSTOM DOSE)",1,22,0.114583333333333,1808,23328,0.0454545454545455,0.0775034293552812,0.586484312148029,21,21520,0.870446024921406
"377",705,"IP MED COMMUNITY ACQUIRED PNEUMONIA",192,"541085","CEFTRIAXONE 1 GRAM/50 ML MINI-BAG PLUS",2,28,0.145833333333333,411,7130,0.0714285714285714,0.0576437587657784,1.23913799096281,26,6719,0.999999999999948
"378",706,"IP MED CHEST PAIN",110,"5604","NITROGLYCERIN 0.4 MG SL SUBL",2,26,0.236363636363636,77,2947,0.0769230769230769,0.0261282660332542,2.94405594405594,24,2870,0.321697156616492
"379",706,"IP MED CHEST PAIN",110,"27838","SODIUM CHLORIDE 0.9 % 0.9 % IV SOLP",1,1,0.00909090909090909,692,19620,1,0.0352701325178389,28.3526011560694,0,18928,0.0118194121841506
"380",708,"IP MED ALCOHOL WITHDRAWAL",2614,"1755","CLONIDINE HCL 0.1 MG PO TABS",11,235,0.0899005355776588,104,2839,0.0468085106382979,0.0366326171187038,1.27778232405892,224,2735,0.54110884859247
"381",708,"IP MED ALCOHOL WITHDRAWAL",2614,"2403","DIAZEPAM 10 MG PO TABS",9,115,0.0439938791124713,37,532,0.0782608695652174,0.0695488721804511,1.12526439482961,106,495,0.896904085330291
"382",708,"IP MED ALCOHOL WITHDRAWAL",2614,"2404","DIAZEPAM 2 MG PO TABS",1,7,0.0026778882938026,52,1512,0.142857142857143,0.0343915343915344,4.15384615384615,6,1460,0.597494144712902
"383",708,"IP MED ALCOHOL WITHDRAWAL",2614,"2405","DIAZEPAM 5 MG PO TABS",9,129,0.0493496557000765,152,5041,0.0697674418604651,0.0301527474707399,2.31380048959608,120,4889,0.0213840021461713
"384",708,"IP MED ALCOHOL WITHDRAWAL",2614,"3233","FOLIC ACID 1 MG PO TABS",11,463,0.177123182861515,58,4621,0.0237580993520518,0.0125513958017745,1.89286512251434,452,4563,0.0756892447566907
"385",708,"IP MED ALCOHOL WITHDRAWAL",2614,"4572","LORAZEPAM 0.5 MG PO TABS",3,34,0.0130068859984698,349,13238,0.0882352941176471,0.0263634990179785,3.34687341985505,31,12889,0.0876299915774757
"386",708,"IP MED ALCOHOL WITHDRAWAL",2614,"4573","LORAZEPAM 1 MG PO TABS",55,1745,0.667559296097934,337,8494,0.0315186246418338,0.0396750647515894,0.794418984295954,1690,8157,0.121428733321273
"387",708,"IP MED ALCOHOL WITHDRAWAL",2614,"4574","LORAZEPAM 2 MG PO TABS",7,200,0.0765110941086457,31,618,0.035,0.0501618122977346,0.697741935483871,193,587,0.488777364316041
"388",708,"IP MED ALCOHOL WITHDRAWAL",2614,"7877","THIAMINE HCL (VITAMIN B1) 100 MG PO TABS",10,449,0.17176740627391,100,3808,0.022271714922049,0.0262605042016807,0.848106904231626,439,3708,0.728891853855425
"389",708,"IP MED ALCOHOL WITHDRAWAL",2614,"10467","LORAZEPAM 2 MG/ML INJ SOLN",72,2181,0.834353481254782,749,20621,0.0330123796423659,0.0363221958197954,0.90887620908575,2109,19872,0.466263819203233
"390",708,"IP MED ALCOHOL WITHDRAWAL",2614,"14858","D5-NS WITH POTASSIUM CHLORIDE 20 MEQ/L IV SOLP",1,42,0.0160673297628156,58,2031,0.0238095238095238,0.0285573609059577,0.833743842364532,41,1973,0.999999999999998
"391",708,"IP MED ALCOHOL WITHDRAWAL",2614,"14863","POTASSIUM CHLORID-D5-0.45%NACL 20 MEQ/L IV SOLP",3,29,0.0110941086457536,314,8762,0.103448275862069,0.035836566993837,2.8866681309027,26,8448,0.146816153806712
"392",708,"IP MED ALCOHOL WITHDRAWAL",2614,"111354","MULTIVITAMIN,TX-IRON-CA-FA-MIN 27-0.4 MG PO TABS",1,1,0.000382555470543229,1,3,1,0.333333333333333,3,0,2,1
"393",708,"IP MED ALCOHOL WITHDRAWAL",2614,"112420","DIAZEPAM 5 MG/ML INJ SYRG",10,129,0.0493496557000765,98,1948,0.0775193798449612,0.0503080082135524,1.54089542793862,119,1850,0.252887252565962
"394",708,"IP MED ALCOHOL WITHDRAWAL",2614,"200346","MAGNESIUM SULFATE IN 0.9 %NACL 2 GRAM/50 ML IV PGBK",2,69,0.0263963274674828,578,30211,0.0289855072463768,0.0191321042004568,1.51501930695552,67,29633,0.875394983302025
"395",708,"IP MED ALCOHOL WITHDRAWAL",2614,"520094","MULTIVITAMINS (+ FOLIC ACID, THIAMINE, VIT K) IVPB",12,240,0.0918133129303749,109,1474,0.05,0.0739484396200814,0.676146788990826,228,1365,0.227311086921812
"396",708,"IP MED ALCOHOL WITHDRAWAL",2614,"540598","THERAPEUTIC MULTIVITAMIN & MINERALS (GENERIC) PO TABS",9,425,0.162586074980872,17,1250,0.0211764705882353,0.0136,1.55709342560554,416,1233,0.387372163120008
"397",712,"IP MED ASTHMA",56,"250","ALBUTEROL SULFATE 2.5 MG /3 ML (0.083 %) INH NEBU",1,6,0.107142857142857,106,3939,0.166666666666667,0.0269103833460269,6.19339622641509,5,3833,0.396297098695298
"398",712,"IP MED ASTHMA",56,"78668","IPRATROPIUM-ALBUTEROL 0.5 MG-3 MG(2.5 MG BASE)/3 ML INH NEBU",1,10,0.178571428571429,493,18456,0.1,0.0267121803207629,3.74361054766734,9,17963,0.64857719149223
"399",713,"IP GEN COMFORT CARE - NON ICU UNITS",2998,"101","ACETAMINOPHEN 325 MG PO TABS",6,127,0.042361574382922,981,42092,0.047244094488189,0.0233060914187969,2.02711358327915,121,41111,0.13659686883043
"400",713,"IP GEN COMFORT CARE - NON ICU UNITS",2998,"105","ACETAMINOPHEN 650 MG PR SUPP",2,146,0.0486991327551701,59,929,0.0136986301369863,0.0635091496232508,0.215695379614581,144,870,0.0260153724506647
"401",713,"IP GEN COMFORT CARE - NON ICU UNITS",2998,"736","ATROPINE 1 % OPHT DROP",1,214,0.0713809206137425,13,270,0.00467289719626168,0.0481481481481481,0.0970524802300503,213,257,0.0104305391765004
"402",713,"IP GEN COMFORT CARE - NON ICU UNITS",2998,"1080","BISACODYL 10 MG PR SUPP",1,145,0.0483655770513676,344,22442,0.00689655172413793,0.0153284021031994,0.449919807538091,144,22098,0.627279379275667
"403",713,"IP GEN COMFORT CARE - NON ICU UNITS",2998,"2508","DIPHENHYDRAMINE HCL 50 MG/ML INJ SOLN",1,114,0.038025350233489,399,16019,0.0087719298245614,0.0249079218428117,0.352174295387592,113,15620,0.422658466658886
"404",713,"IP GEN COMFORT CARE - NON ICU UNITS",2998,"3497","GLYCOPYRROLATE 0.2 MG/ML INJ SOLN",2,431,0.143762508338893,61,1031,0.00464037122969838,0.0591658583899127,0.0784298809478529,429,970,5.62496732215015e-06
"405",713,"IP GEN COMFORT CARE - NON ICU UNITS",2998,"3578","HALOPERIDOL 0.5 MG PO TABS",1,47,0.0156771180787191,36,753,0.0212765957446809,0.047808764940239,0.445035460992908,46,717,0.629587366190285
"406",713,"IP GEN COMFORT CARE - NON ICU UNITS",2998,"3584","HALOPERIDOL LACTATE 5 MG/ML INJ SOLN",4,157,0.052368245496998,513,10794,0.0254777070063694,0.047526403557532,0.536074794204194,153,10281,0.26971024314078
"407",713,"IP GEN COMFORT CARE - NON ICU UNITS",2998,"4572","LORAZEPAM 0.5 MG PO TABS",3,141,0.0470313542361574,349,13238,0.0212765957446809,0.0263634990179785,0.807047491312565,138,12889,0.911680199736014
"408",713,"IP GEN COMFORT CARE - NON ICU UNITS",2998,"4573","LORAZEPAM 1 MG PO TABS",1,23,0.00767178118745831,337,8494,0.0434782608695652,0.0396750647515894,1.09585859889047,22,8157,0.999999999999998
"409",713,"IP GEN COMFORT CARE - NON ICU UNITS",2998,"5002","METOCLOPRAMIDE HCL 5 MG/ML INJ SOLN",3,237,0.0790527018012008,346,10128,0.0126582278481013,0.0341627172195893,0.370527548108583,234,9782,0.102664656162082
"410",713,"IP GEN COMFORT CARE - NON ICU UNITS",2998,"5172","MORPHINE 4 MG/ML INJ SYRG",21,409,0.136424282855237,238,5949,0.0513447432762836,0.0400067238191293,1.28340284769164,388,5711,0.320843252507469
"411",713,"IP GEN COMFORT CARE - NON ICU UNITS",2998,"5176","MORPHINE 10 MG/5 ML PO SOLN",6,114,0.038025350233489,156,3537,0.0526315789473684,0.0441051738761662,1.19331983805668,108,3381,0.838280977645218
"412",713,"IP GEN COMFORT CARE - NON ICU UNITS",2998,"6583","PROCHLORPERAZINE MALEATE 5 MG PO TABS",1,38,0.0126751167444963,18,681,0.0263157894736842,0.026431718061674,0.995614035087719,37,663,0.999999999999999
"413",713,"IP GEN COMFORT CARE - NON ICU UNITS",2998,"10467","LORAZEPAM 2 MG/ML INJ SOLN",10,462,0.154102735156771,749,20621,0.0216450216450216,0.0363221958197954,0.595917211404528,452,19872,0.121496091724913
"414",713,"IP GEN COMFORT CARE - NON ICU UNITS",2998,"11349","SENNOSIDES 8.6 MG PO TABS",3,136,0.0453635757171448,610,35793,0.0220588235294118,0.0170424384656218,1.29434667309547,133,35183,0.905133339866658
"415",713,"IP GEN COMFORT CARE - NON ICU UNITS",2998,"12556","DIPHENHYDRAMINE HCL 25 MG PO CAPS",2,23,0.00767178118745831,29,344,0.0869565217391304,0.0843023255813953,1.03148425787106,21,315,0.999999999999999
"416",713,"IP GEN COMFORT CARE - NON ICU UNITS",2998,"86533","MAGNESIUM HYDROXIDE 400 MG/5 ML PO SUSP",2,109,0.0363575717144763,111,6618,0.018348623853211,0.0167724388032638,1.09397470865361,107,6507,0.999999999999997
"417",713,"IP GEN COMFORT CARE - NON ICU UNITS",2998,"90206","SODIUM PHOSPHATES 19-7 GRAM/118 ML PR ENEM",3,110,0.0366911274182789,101,3581,0.0272727272727273,0.02820441217537,0.966966696669667,107,3480,0.99999999999992
"418",713,"IP GEN COMFORT CARE - NON ICU UNITS",2998,"93305","SCOPOLAMINE BASE 1.5 MG (1 MG OVER 3 DAYS) TD PT3D",7,145,0.0483655770513676,93,5289,0.0482758620689655,0.0175836642087351,2.74549499443826,138,5196,0.0164067403754389
"419",713,"IP GEN COMFORT CARE - NON ICU UNITS",2998,"95795","ARTIFICIAL TEARS(HYPROMELLOSE) 0.5 % OPHT DROP",3,380,0.126751167444963,38,2949,0.00789473684210526,0.0128857239742286,0.612673130193906,377,2911,0.559777542002666
"420",713,"IP GEN COMFORT CARE - NON ICU UNITS",2998,"110872","HYDROMORPHONE 2 MG/ML INJ SYRG",4,101,0.033689126084056,738,23934,0.0396039603960396,0.0308347956881424,1.28439185381953,97,23196,0.825720100418033
"421",713,"IP GEN COMFORT CARE - NON ICU UNITS",2998,"112586","HYDROMORPHONE 1 MG/ML INJ SYRG",12,117,0.0390260173448966,1219,33427,0.102564102564103,0.036467526251234,2.81247765086978,105,32208,0.000385847248599031
"422",713,"IP GEN COMFORT CARE - NON ICU UNITS",2998,"117414","ARTIFICIAL SALIVA (YERBAS-LYT) MM SPRA",30,429,0.143095396931288,38,452,0.0699300699300699,0.084070796460177,0.8317997791682,399,414,0.509392880193195
"423",713,"IP GEN COMFORT CARE - NON ICU UNITS",2998,"200439","HYDROMORPHONE (PF) 2 MG/ML INJ SOLN",2,37,0.0123415610406938,142,3356,0.0540540540540541,0.0423122765196663,1.27750285496764,35,3214,0.999999999999998
"424",713,"IP GEN COMFORT CARE - NON ICU UNITS",2998,"207949","MORPHINE (PF) 30 MG/30 ML (1 MG/ML) IV PCA",2,38,0.0126751167444963,59,774,0.0526315789473684,0.0762273901808786,0.690454950936664,36,715,0.823087978989777
"425",713,"IP GEN COMFORT CARE - NON ICU UNITS",2998,"540991","HYDROMORPHONE 1 MG/ML IV PCA CONTINUOUS INFUSION",4,85,0.0283522348232155,1,48,0.0470588235294118,0.0208333333333333,2.25882352941176,81,47,0.772549328119066
"426",713,"IP GEN COMFORT CARE - NON ICU UNITS",2998,"541048","HYDROMORPHONE VARIABLE DOSE INJECTION",1,8,0.00266844563042028,104,5739,0.125,0.0181216239763025,6.89783653846154,7,5635,0.349922694280945
"427",713,"IP GEN COMFORT CARE - NON ICU UNITS",2998,"541607","HYDROMORPHONE 1 MG/ML IV PCA",5,76,0.0253502334889927,124,1939,0.0657894736842105,0.0639504899432697,1.02875636672326,71,1815,0.999999999999998
"428",713,"IP GEN COMFORT CARE - NON ICU UNITS",2998,"541609","MORPHINE 30 MG/30 ML IV PCA",7,91,0.0303535690460307,12,223,0.0769230769230769,0.0538116591928251,1.42948717948718,84,211,0.604184636049917
"429",716,"IP GYN EXLAP/TAH/BSO GENERAL",549,"5002","METOCLOPRAMIDE HCL 5 MG/ML INJ SOLN",1,210,0.382513661202186,346,10128,0.00476190476190476,0.0341627172195893,0.139388934764657,209,9782,0.0317235271647411
"430",716,"IP GYN EXLAP/TAH/BSO GENERAL",549,"27838","SODIUM CHLORIDE 0.9 % 0.9 % IV SOLP",1,57,0.103825136612022,692,19620,0.0175438596491228,0.0352701325178389,0.497414055369638,56,18928,0.714980269303959
"431",716,"IP GYN EXLAP/TAH/BSO GENERAL",549,"88043","PANTOPRAZOLE 40 MG PO TBEC",1,25,0.0455373406193078,624,31884,0.04,0.0195709446744449,2.04384615384615,24,31260,0.988104616819441
"432",716,"IP GYN EXLAP/TAH/BSO GENERAL",549,"110872","HYDROMORPHONE 2 MG/ML INJ SYRG",1,32,0.058287795992714,738,23934,0.03125,0.0308347956881424,1.01346544715447,31,23196,0.99999999999907
"433",716,"IP GYN EXLAP/TAH/BSO GENERAL",549,"202606","FAMOTIDINE (PF) 20 MG/2 ML IV SOLN",1,7,0.0127504553734062,288,4280,0.142857142857143,0.0672897196261682,2.12301587301587,6,3992,0.966175414383934
"434",716,"IP GYN EXLAP/TAH/BSO GENERAL",549,"212945","HEPARIN, PORCINE (PF) 5,000 UNIT/0.5 ML INJ SOLN",1,39,0.0710382513661202,452,13480,0.0256410256410256,0.0335311572700297,0.764692534604039,38,13028,0.999999999999991
"435",716,"IP GYN EXLAP/TAH/BSO GENERAL",549,"541104","CEFOXITIN 1 GRAM/50 ML MINI-BAG PLUS",1,1,0.00182149362477231,9,214,1,0.0420560747663551,23.7777777777778,0,205,0.0308936201712197
"436",720,"IP GYN-ONC LAPAROSCOPY POSTOP",350,"5002","METOCLOPRAMIDE HCL 5 MG/ML INJ SOLN",1,141,0.402857142857143,346,10128,0.00709219858156028,0.0341627172195893,0.207600541138851,140,9782,0.125505970066428
"437",720,"IP GYN-ONC LAPAROSCOPY POSTOP",350,"5002","METOCLOPRAMIDE HCL 5 MG/ML INJ SOLN",1,141,0.402857142857143,346,10128,0.00709219858156028,0.0341627172195893,0.207600541138851,140,9782,0.125505970066428
"438",720,"IP GYN-ONC LAPAROSCOPY POSTOP",350,"22472","KETOROLAC 15 MG/ML INJ SOLN",2,48,0.137142857142857,215,5031,0.0416666666666667,0.0427350427350427,0.975,46,4816,0.999999999999994
"439",720,"IP GYN-ONC LAPAROSCOPY POSTOP",350,"22472","KETOROLAC 15 MG/ML INJ SOLN",2,48,0.137142857142857,215,5031,0.0416666666666667,0.0427350427350427,0.975,46,4816,0.999999999999994
"440",720,"IP GYN-ONC LAPAROSCOPY POSTOP",350,"27838","SODIUM CHLORIDE 0.9 % 0.9 % IV SOLP",1,21,0.06,692,19620,0.0476190476190476,0.0352701325178389,1.35012386457473,20,18928,0.99999999999996
"441",720,"IP GYN-ONC LAPAROSCOPY POSTOP",350,"27838","SODIUM CHLORIDE 0.9 % 0.9 % IV SOLP",1,21,0.06,692,19620,0.0476190476190476,0.0352701325178389,1.35012386457473,20,18928,0.99999999999996
"442",720,"IP GYN-ONC LAPAROSCOPY POSTOP",350,"34505","HYDROCODONE-ACETAMINOPHEN 5-325 MG PO TABS",1,27,0.0771428571428571,603,24164,0.037037037037037,0.0249544777354743,1.4841840181807,26,23561,0.999999999998922
"443",720,"IP GYN-ONC LAPAROSCOPY POSTOP",350,"34505","HYDROCODONE-ACETAMINOPHEN 5-325 MG PO TABS",1,27,0.0771428571428571,603,24164,0.037037037037037,0.0249544777354743,1.4841840181807,26,23561,0.999999999998922
"444",720,"IP GYN-ONC LAPAROSCOPY POSTOP",350,"110892","ENOXAPARIN 40 MG/0.4 ML SC SYRG",2,50,0.142857142857143,499,13896,0.04,0.0359096142774899,1.11390781563126,48,13397,0.999999999999989
"445",720,"IP GYN-ONC LAPAROSCOPY POSTOP",350,"110892","ENOXAPARIN 40 MG/0.4 ML SC SYRG",2,50,0.142857142857143,499,13896,0.04,0.0359096142774899,1.11390781563126,48,13397,0.999999999999989
"446",720,"IP GYN-ONC LAPAROSCOPY POSTOP",350,"198509","ONDANSETRON HCL (PF) 4 MG/2 ML INJ SOLN",2,136,0.388571428571429,705,36939,0.0147058823529412,0.0190855193697718,0.770525657071339,134,36234,0.953195192475283
"447",720,"IP GYN-ONC LAPAROSCOPY POSTOP",350,"198509","ONDANSETRON HCL (PF) 4 MG/2 ML INJ SOLN",2,136,0.388571428571429,705,36939,0.0147058823529412,0.0190855193697718,0.770525657071339,134,36234,0.953195192475283
"448",720,"IP GYN-ONC LAPAROSCOPY POSTOP",350,"202606","FAMOTIDINE (PF) 20 MG/2 ML IV SOLN",3,20,0.0571428571428571,288,4280,0.15,0.0672897196261682,2.22916666666667,17,3992,0.306303270163958
"449",720,"IP GYN-ONC LAPAROSCOPY POSTOP",350,"202606","FAMOTIDINE (PF) 20 MG/2 ML IV SOLN",3,20,0.0571428571428571,288,4280,0.15,0.0672897196261682,2.22916666666667,17,3992,0.306303270163958
"450",721,"IP GYN-ONC OPEN ABDOMINAL HYSTERECTOMY POSTOP",244,"2566","DOCUSATE SODIUM 100 MG PO CAPS",1,73,0.299180327868852,542,37509,0.0136986301369863,0.0144498653656456,0.948010918465349,72,36967,0.999999999998483
"451",721,"IP GYN-ONC OPEN ABDOMINAL HYSTERECTOMY POSTOP",244,"5002","METOCLOPRAMIDE HCL 5 MG/ML INJ SOLN",4,93,0.381147540983607,346,10128,0.043010752688172,0.0341627172195893,1.25899683013239,89,9782,0.856636271657988
"452",721,"IP GYN-ONC OPEN ABDOMINAL HYSTERECTOMY POSTOP",244,"110892","ENOXAPARIN 40 MG/0.4 ML SC SYRG",3,47,0.192622950819672,499,13896,0.0638297872340425,0.0359096142774899,1.77751247175201,44,13397,0.526365873320431
"453",721,"IP GYN-ONC OPEN ABDOMINAL HYSTERECTOMY POSTOP",244,"198509","ONDANSETRON HCL (PF) 4 MG/2 ML INJ SOLN",1,91,0.372950819672131,705,36939,0.010989010989011,0.0190855193697718,0.575777414075286,90,36234,0.856888421801969
"454",724,"RETIRED IP GYN-ONC  BOWEL OBSTRUCTION",128,"5002","METOCLOPRAMIDE HCL 5 MG/ML INJ SOLN",1,51,0.3984375,346,10128,0.0196078431372549,0.0341627172195893,0.573954437266236,50,9782,0.85356733622982
"455",724,"RETIRED IP GYN-ONC  BOWEL OBSTRUCTION",128,"110872","HYDROMORPHONE 2 MG/ML INJ SYRG",1,23,0.1796875,738,23934,0.0434782608695652,0.0308347956881424,1.41003888299753,22,23196,0.999999999999992
"456",724,"RETIRED IP GYN-ONC  BOWEL OBSTRUCTION",128,"110892","ENOXAPARIN 40 MG/0.4 ML SC SYRG",1,16,0.125,499,13896,0.0625,0.0359096142774899,1.74048096192385,15,13397,0.999999999999996
"457",724,"RETIRED IP GYN-ONC  BOWEL OBSTRUCTION",128,"112586","HYDROMORPHONE 1 MG/ML INJ SYRG",1,18,0.140625,1219,33427,0.0555555555555556,0.036467526251234,1.52342539422113,17,32208,0.999999999999581
"458",724,"RETIRED IP GYN-ONC  BOWEL OBSTRUCTION",128,"202606","FAMOTIDINE (PF) 20 MG/2 ML IV SOLN",1,3,0.0234375,288,4280,0.333333333333333,0.0672897196261682,4.9537037037037,2,3992,0.493256486855763
"459",724,"RETIRED IP GYN-ONC  BOWEL OBSTRUCTION",128,"212945","HEPARIN, PORCINE (PF) 5,000 UNIT/0.5 ML INJ SOLN",1,2,0.015625,452,13480,0.5,0.0335311572700297,14.9115044247788,1,13028,0.0894223689889605
"460",727,"IP GYN MINIMALLY INVASIVE SURGERY POSTOP",1017,"2566","DOCUSATE SODIUM 100 MG PO CAPS",3,263,0.258603736479843,542,37509,0.0114068441064639,0.0144498653656456,0.789408331345671,260,36967,0.878444695678504
"461",727,"IP GYN MINIMALLY INVASIVE SURGERY POSTOP",1017,"3844","IBUPROFEN 600 MG PO TABS",1,72,0.0707964601769911,98,3745,0.0138888888888889,0.0261682242990654,0.530753968253968,71,3647,0.783283735686736
"462",727,"IP GYN MINIMALLY INVASIVE SURGERY POSTOP",1017,"5002","METOCLOPRAMIDE HCL 5 MG/ML INJ SOLN",8,377,0.370698131760079,346,10128,0.0212201591511936,0.0341627172195893,0.621149629720489,369,9782,0.221684848383796
"463",727,"IP GYN MINIMALLY INVASIVE SURGERY POSTOP",1017,"22472","KETOROLAC 15 MG/ML INJ SOLN",2,132,0.129793510324484,215,5031,0.0151515151515152,0.0427350427350427,0.354545454545455,130,4816,0.180462699926563
"464",727,"IP GYN MINIMALLY INVASIVE SURGERY POSTOP",1017,"34505","HYDROCODONE-ACETAMINOPHEN 5-325 MG PO TABS",2,81,0.079646017699115,603,24164,0.0246913580246914,0.0249544777354743,0.989456012120468,79,23561,0.999999999999341
"465",727,"IP GYN MINIMALLY INVASIVE SURGERY POSTOP",1017,"82384","PANTOPRAZOLE 40 MG IV SOLR",1,28,0.0275319567354966,688,12925,0.0357142857142857,0.0532301740812379,0.67094061461794,27,12237,0.999999999999773
"466",727,"IP GYN MINIMALLY INVASIVE SURGERY POSTOP",1017,"88043","PANTOPRAZOLE 40 MG PO TBEC",2,56,0.0550639134709931,624,31884,0.0357142857142857,0.0195709446744449,1.82486263736264,54,31260,0.697793040275935
"467",727,"IP GYN MINIMALLY INVASIVE SURGERY POSTOP",1017,"110872","HYDROMORPHONE 2 MG/ML INJ SYRG",1,120,0.117994100294985,738,23934,0.00833333333333333,0.0308347956881424,0.270257452574526,119,23196,0.246184795274719
"468",727,"IP GYN MINIMALLY INVASIVE SURGERY POSTOP",1017,"110892","ENOXAPARIN 40 MG/0.4 ML SC SYRG",1,98,0.0963618485742379,499,13896,0.0102040816326531,0.0359096142774899,0.284160157048791,97,13397,0.274355035909218
"469",727,"IP GYN MINIMALLY INVASIVE SURGERY POSTOP",1017,"112586","HYDROMORPHONE 1 MG/ML INJ SYRG",2,82,0.0806293018682399,1219,33427,0.024390243902439,0.036467526251234,0.668820904780008,80,32208,0.773418459248555
"470",727,"IP GYN MINIMALLY INVASIVE SURGERY POSTOP",1017,"198509","ONDANSETRON HCL (PF) 4 MG/2 ML INJ SOLN",7,399,0.392330383480826,705,36939,0.0175438596491228,0.0190855193697718,0.919223590892124,392,36234,0.968135072220526
"471",727,"IP GYN MINIMALLY INVASIVE SURGERY POSTOP",1017,"200439","HYDROMORPHONE (PF) 2 MG/ML INJ SOLN",1,12,0.0117994100294985,142,3356,0.0833333333333333,0.0423122765196663,1.96948356807512,11,3214,0.999999999999998
"472",727,"IP GYN MINIMALLY INVASIVE SURGERY POSTOP",1017,"212945","HEPARIN, PORCINE (PF) 5,000 UNIT/0.5 ML INJ SOLN",1,34,0.0334316617502458,452,13480,0.0294117647058824,0.0335311572700297,0.877147319104633,33,13028,0.999999999999965
"473",727,"IP GYN MINIMALLY INVASIVE SURGERY POSTOP",1017,"541048","HYDROMORPHONE VARIABLE DOSE INJECTION",1,26,0.0255653883972468,104,5739,0.0384615384615385,0.0181216239763025,2.12241124260355,25,5635,0.968983521688516
"474",728,"NURSING TRIAGE HIP FRACTURE SYMPTOMS PROTOCOL",106,"101","ACETAMINOPHEN 325 MG PO TABS",1,4,0.0377358490566038,981,42092,0.25,0.0233060914187969,10.7268093781855,3,41111,0.177904126837166
"475",728,"NURSING TRIAGE HIP FRACTURE SYMPTOMS PROTOCOL",106,"10814","OXYCODONE 5 MG PO TABS",2,6,0.0566037735849057,1478,56614,0.333333333333333,0.0261066167379094,12.7681551646369,4,55136,0.000588146887172436
"476",728,"NURSING TRIAGE HIP FRACTURE SYMPTOMS PROTOCOL",106,"112586","HYDROMORPHONE 1 MG/ML INJ SYRG",1,12,0.113207547169811,1219,33427,0.0833333333333333,0.036467526251234,2.28513809133169,11,32208,0.923706605188143
"477",730,"ED RAPID SEQUENCE INDUCTION INTUBATION",7,"7536","SUCCINYLCHOLINE CHLORIDE 20 MG/ML INJ SOLN",1,2,0.285714285714286,28,870,0.5,0.032183908045977,15.5357142857143,1,842,0.086999225120579
"478",730,"ED RAPID SEQUENCE INDUCTION INTUBATION",7,"112552","ETOMIDATE 2 MG/ML IV SYRG",1,4,0.571428571428571,5,94,0.25,0.0531914893617021,4.7,3,89,0.586966425239004
"479",732,"ED TIA PATHWAY",385,"10372","LABETALOL 5 MG/ML IV SOLN",1,3,0.00779220779220779,370,5898,0.333333333333333,0.0627331298745337,5.31351351351351,2,5528,0.458787148513899
"480",732,"ED TIA PATHWAY",385,"10372","LABETALOL 5 MG/ML IV SOLN",1,3,0.00779220779220779,370,5898,0.333333333333333,0.0627331298745337,5.31351351351351,2,5528,0.458787148513899
"481",732,"ED TIA PATHWAY",385,"530010","NICARDIPINE IV INFUSION",1,3,0.00779220779220779,257,676,0.333333333333333,0.380177514792899,0.876783398184176,2,419,0.999999999999976
"482",732,"ED TIA PATHWAY",385,"530010","NICARDIPINE IV INFUSION",1,3,0.00779220779220779,257,676,0.333333333333333,0.380177514792899,0.876783398184176,2,419,0.999999999999976
"483",733,"ED PROCEDURAL SEDATION MEDS",54,"10607","MIDAZOLAM 1 MG/ML INJ SOLN",2,11,0.203703703703704,155,5616,0.181818181818182,0.0275997150997151,6.58768328445748,9,5461,0.0287847158219268
"484",733,"ED PROCEDURAL SEDATION MEDS",54,"90587","KETAMINE 10 MG/ML INJ SOLN",1,10,0.185185185185185,24,389,0.1,0.0616966580976864,1.62083333333333,9,365,0.999999999999999
"485",734,"ED CHEST PAIN",802,"101","ACETAMINOPHEN 325 MG PO TABS",1,2,0.00249376558603491,981,42092,0.5,0.0233060914187969,21.453618756371,1,41111,0.0336916546422699
"486",734,"ED CHEST PAIN",802,"680","ASPIRIN 81 MG PO CHEW",2,84,0.104738154613466,357,11203,0.0238095238095238,0.031866464339909,0.747165532879819,82,10846,0.914642865731449
"487",734,"ED CHEST PAIN",802,"5604","NITROGLYCERIN 0.4 MG SL SUBL",2,45,0.0561097256857855,77,2947,0.0444444444444444,0.0261282660332542,1.7010101010101,43,2870,0.770184058410116
"488",734,"ED CHEST PAIN",802,"10176","HEPARIN (PORCINE) 1,000 UNIT/ML INJ SOLN",5,25,0.0311720698254364,164,2898,0.2,0.0565907522429262,3.53414634146342,20,2734,0.00857006953426814
"489",734,"ED CHEST PAIN",802,"15846","HEPARIN (PORCINE) IN 5 % DEX 25,000 UNIT/250 ML(100 UNIT/ML) IV SOLP",6,25,0.0311720698254364,68,899,0.24,0.0756395995550612,3.17294117647059,19,831,0.00897627499745524
"490",734,"ED CHEST PAIN",802,"15859","NITROGLYCERIN IN 5 % DEXTROSE 50 MG/250 ML (200 MCG/ML) IV SOLN",2,4,0.00498753117206983,71,1104,0.5,0.0643115942028985,7.77464788732394,2,1033,0.012539977241793
"491",734,"ED CHEST PAIN",802,"78668","IPRATROPIUM-ALBUTEROL 0.5 MG-3 MG(2.5 MG BASE)/3 ML INH NEBU",1,7,0.00872817955112219,493,18456,0.142857142857143,0.0267121803207629,5.3480150680962,6,17963,0.463822858416398
"492",734,"ED CHEST PAIN",802,"83398","CLOPIDOGREL 75 MG PO TABS",1,1,0.00124688279301746,234,7279,1,0.0321472729770573,31.1068376068376,0,7045,0.00813285995730957
"493",734,"ED CHEST PAIN",802,"112586","HYDROMORPHONE 1 MG/ML INJ SYRG",1,11,0.013715710723192,1219,33427,0.0909090909090909,0.036467526251234,2.49287791781639,10,32208,0.873919262213904
"494",734,"ED CHEST PAIN",802,"520002","DEXAMETHASONE (CUSTOM DOSE) IVPB",3,3,0.00374064837905237,168,1360,1,0.123529411764706,8.09523809523809,0,1192,0.000210914477633671
"495",734,"ED CHEST PAIN",802,"540102","NS IV BOLUS",2,42,0.0523690773067332,2225,80957,0.0476190476190476,0.0274837259285794,1.73262707330123,40,78732,0.744520095036611
"496",737,"IP PLS GENERAL POSTOP",1019,"2566","DOCUSATE SODIUM 100 MG PO CAPS",5,245,0.240431795878312,542,37509,0.0204081632653061,0.0144498653656456,1.41234279689736,240,36967,0.61023015410504
"497",737,"IP PLS GENERAL POSTOP",1019,"5002","METOCLOPRAMIDE HCL 5 MG/ML INJ SOLN",2,371,0.364082433758587,346,10128,0.00539083557951483,0.0341627172195893,0.157798794073197,369,9782,0.0038173242845358
"498",737,"IP PLS GENERAL POSTOP",1019,"9626","CLINDAMYCIN IN 5 % DEXTROSE 600 MG/50 ML IV PGBK",1,19,0.0186457311089303,70,1432,0.0526315789473684,0.0488826815642458,1.07669172932331,18,1362,0.999999999999937
"499",737,"IP PLS GENERAL POSTOP",1019,"25365","CEFAZOLIN IN DEXTROSE (ISO-OS) 1 GRAM/50 ML IV PGBK",1,143,0.140333660451423,258,5335,0.00699300699300699,0.0483598875351453,0.144603458556947,142,5077,0.0356833746070618
"500",737,"IP PLS GENERAL POSTOP",1019,"34505","HYDROCODONE-ACETAMINOPHEN 5-325 MG PO TABS",2,170,0.166830225711482,603,24164,0.0117647058823529,0.0249544777354743,0.471446688127987,168,23561,0.393402442892753
"501",737,"IP PLS GENERAL POSTOP",1019,"110872","HYDROMORPHONE 2 MG/ML INJ SYRG",3,137,0.134445534838077,738,23934,0.0218978102189781,0.0308347956881424,0.710165568808973,134,23196,0.721952711328159
"502",737,"IP PLS GENERAL POSTOP",1019,"110892","ENOXAPARIN 40 MG/0.4 ML SC SYRG",2,78,0.0765456329735034,499,13896,0.0256410256410256,0.0359096142774899,0.714043471558502,76,13397,0.856317351013013
"503",737,"IP PLS GENERAL POSTOP",1019,"112586","HYDROMORPHONE 1 MG/ML INJ SYRG",1,89,0.0873405299313052,1219,33427,0.0112359550561798,0.036467526251234,0.308108506696408,88,32208,0.324172733799476
"504",737,"IP PLS GENERAL POSTOP",1019,"124216","VANCOMYCIN IN D5W 1 GRAM/200 ML IV PGBK",2,23,0.0225711481844946,1951,16917,0.0869565217391304,0.115327776792576,0.753994607001983,21,14966,0.921074617335404
"505",737,"IP PLS GENERAL POSTOP",1019,"124873","SENNA LEAF EXTRACT 176 MG/5 ML PO SYRP",1,85,0.0834151128557409,90,4112,0.0117647058823529,0.0218871595330739,0.537516339869281,84,4022,0.796363226334638
"506",737,"IP PLS GENERAL POSTOP",1019,"198509","ONDANSETRON HCL (PF) 4 MG/2 ML INJ SOLN",2,383,0.37585868498528,705,36939,0.00522193211488251,0.0190855193697718,0.27360702183212,381,36234,0.073197160881978
"507",739,"IP PLS OUTPT PROCEDURE PRE/POSTOP",13,"1445","CEFAZOLIN 1 GRAM INJ SOLR",1,4,0.307692307692308,47,571,0.25,0.0823117338003503,3.03723404255319,3,524,0.763204685121939
"508",739,"IP PLS OUTPT PROCEDURE PRE/POSTOP",13,"25365","CEFAZOLIN IN DEXTROSE (ISO-OS) 1 GRAM/50 ML IV PGBK",1,2,0.153846153846154,258,5335,0.5,0.0483598875351453,10.3391472868217,1,5077,0.184772868055709
"509",740,"IP VAS GENERAL ADMIT",2310,"101","ACETAMINOPHEN 325 MG PO TABS",4,161,0.0696969696969697,981,42092,0.0248447204968944,0.0233060914187969,1.06601832329794,157,41111,0.999999999999125
"510",740,"IP VAS GENERAL ADMIT",2310,"105","ACETAMINOPHEN 650 MG PR SUPP",1,5,0.00216450216450216,59,929,0.2,0.0635091496232508,3.14915254237288,4,870,0.743657659348636
"511",740,"IP VAS GENERAL ADMIT",2310,"681","ASPIRIN 325 MG PO TABS",1,10,0.00432900432900433,303,7114,0.1,0.0425920719707619,2.34785478547855,9,6811,0.908665509248172
"512",740,"IP VAS GENERAL ADMIT",2310,"1080","BISACODYL 10 MG PR SUPP",3,465,0.201298701298701,344,22442,0.00645161290322581,0.0153284021031994,0.420892723180795,462,22098,0.174022821673567
"513",740,"IP VAS GENERAL ADMIT",2310,"2566","DOCUSATE SODIUM 100 MG PO CAPS",14,480,0.207792207792208,542,37509,0.0291666666666667,0.0144498653656456,2.01847324723247,466,36967,0.0132630339395493
"514",740,"IP VAS GENERAL ADMIT",2310,"2567","DOCUSATE SODIUM 250 MG PO CAPS",2,169,0.0731601731601732,296,17760,0.0118343195266272,0.0166666666666667,0.710059171597633,167,17464,0.851830838414866
"515",740,"IP VAS GENERAL ADMIT",2310,"3843","IBUPROFEN 400 MG PO TABS",1,2,0.000865800865800866,148,4216,0.5,0.0351043643263757,14.2432432432432,1,4068,0.0999670321487003
"516",740,"IP VAS GENERAL ADMIT",2310,"4318","LACTATED RINGERS IV SOLP",2,137,0.0593073593073593,135,4847,0.0145985401459854,0.0278522797606767,0.524141659908083,135,4712,0.502384453299298
"517",740,"IP VAS GENERAL ADMIT",2310,"4711","MAGNESIUM CITRATE PO SOLN",4,292,0.126406926406926,131,5481,0.0136986301369863,0.0239007480386791,0.573146502143679,288,5350,0.354793030987847
"518",740,"IP VAS GENERAL ADMIT",2310,"5002","METOCLOPRAMIDE HCL 5 MG/ML INJ SOLN",2,209,0.0904761904761905,346,10128,0.00956937799043062,0.0341627172195893,0.280111734933761,207,9782,0.0788381985435139
"519",740,"IP VAS GENERAL ADMIT",2310,"5373","NALOXONE 0.4 MG/ML INJ SOLN",4,789,0.341558441558442,83,1774,0.00506970849176172,0.0467869222096956,0.108357383908257,785,1691,1.39874882379723e-07
"520",740,"IP VAS GENERAL ADMIT",2310,"11349","SENNOSIDES 8.6 MG PO TABS",2,614,0.265800865800866,610,35793,0.00325732899022801,0.0170424384656218,0.191130453356117,612,35183,0.013278685189965
"521",740,"IP VAS GENERAL ADMIT",2310,"14863","POTASSIUM CHLORID-D5-0.45%NACL 20 MEQ/L IV SOLP",3,153,0.0662337662337662,314,8762,0.0196078431372549,0.035836566993837,0.547146247033845,150,8448,0.392848320210679
"522",740,"IP VAS GENERAL ADMIT",2310,"25365","CEFAZOLIN IN DEXTROSE (ISO-OS) 1 GRAM/50 ML IV PGBK",2,61,0.0264069264069264,258,5335,0.0327868852459016,0.0483598875351453,0.677976871266997,59,5077,0.791710077752991
"523",740,"IP VAS GENERAL ADMIT",2310,"28384","HYDROCODONE-ACETAMINOPHEN 10-325 MG PO TABS",1,22,0.00952380952380952,335,9576,0.0454545454545455,0.0349832915622389,1.29932157394844,21,9241,0.999999999999408
"524",740,"IP VAS GENERAL ADMIT",2310,"34505","HYDROCODONE-ACETAMINOPHEN 5-325 MG PO TABS",2,260,0.112554112554113,603,24164,0.00769230769230769,0.0249544777354743,0.308253603775992,258,23561,0.113943301644733
"525",740,"IP VAS GENERAL ADMIT",2310,"86533","MAGNESIUM HYDROXIDE 400 MG/5 ML PO SUSP",4,418,0.180952380952381,111,6618,0.00956937799043062,0.0167724388032638,0.570541833699728,414,6507,0.353645071947417
"526",740,"IP VAS GENERAL ADMIT",2310,"90206","SODIUM PHOSPHATES 19-7 GRAM/118 ML PR ENEM",4,232,0.1004329004329,101,3581,0.0172413793103448,0.02820441217537,0.611300785250939,228,3480,0.43427917618779
"527",740,"IP VAS GENERAL ADMIT",2310,"96559","PIPERACILLIN-TAZOBACTAM-DEXTRS 3.375 GRAM/50 ML IV PGBK",3,37,0.016017316017316,1067,10067,0.0810810810810811,0.105989867885169,0.764988981483827,34,9000,0.822859489102926
"528",740,"IP VAS GENERAL ADMIT",2310,"110872","HYDROMORPHONE 2 MG/ML INJ SYRG",4,233,0.100865800865801,738,23934,0.0171673819742489,0.0308347956881424,0.556753550368122,229,23196,0.311209139853855
"529",740,"IP VAS GENERAL ADMIT",2310,"112586","HYDROMORPHONE 1 MG/ML INJ SYRG",2,203,0.0878787878787879,1219,33427,0.00985221674876847,0.036467526251234,0.270164109320003,201,32208,0.0668052816908448
"530",740,"IP VAS GENERAL ADMIT",2310,"198509","ONDANSETRON HCL (PF) 4 MG/2 ML INJ SOLN",3,401,0.173593073593074,705,36939,0.00748129675810474,0.0190855193697718,0.391988114819335,398,36234,0.130903014268123
"531",740,"IP VAS GENERAL ADMIT",2310,"200439","HYDROMORPHONE (PF) 2 MG/ML INJ SOLN",1,12,0.00519480519480519,142,3356,0.0833333333333333,0.0423122765196663,1.96948356807512,11,3214,0.999999999999998
"532",740,"IP VAS GENERAL ADMIT",2310,"212945","HEPARIN, PORCINE (PF) 5,000 UNIT/0.5 ML INJ SOLN",1,119,0.0515151515151515,452,13480,0.00840336134453781,0.0335311572700297,0.250613519744181,118,13028,0.206128642482156
"533",740,"IP VAS GENERAL ADMIT",2310,"221636","PROCHLORPERAZINE EDISYLATE 10 MG/2 ML (5 MG/ML) INJ SOLN",1,60,0.025974025974026,177,6874,0.0166666666666667,0.0257491998836194,0.647269303201507,59,6697,0.973683858705024
"534",740,"IP VAS GENERAL ADMIT",2310,"500027","D5W WITH SODIUM BICARBONATE 154 MEQ/L  IV INFUSION FOR CONTRAST STUDY",7,82,0.0354978354978355,54,1287,0.0853658536585366,0.041958041958042,2.03455284552846,75,1233,0.116153048493325
"535",740,"IP VAS GENERAL ADMIT",2310,"540184","ACETYLCYSTEINE 20 % (200MG/ML) ORAL SOLN",3,65,0.0281385281385281,77,1458,0.0461538461538462,0.0528120713305898,0.873926073926074,62,1381,0.999999999999998
"536",740,"IP VAS GENERAL ADMIT",2310,"541048","HYDROMORPHONE VARIABLE DOSE INJECTION",1,37,0.016017316017316,104,5739,0.027027027027027,0.0181216239763025,1.49142411642412,36,5635,0.999999999999645
"537",741,"IP VAS GENERAL POSTOP",1423,"1080","BISACODYL 10 MG PR SUPP",3,378,0.265635980323261,344,22442,0.00793650793650794,0.0153284021031994,0.517764857881137,375,22098,0.340727403014271
"538",741,"IP VAS GENERAL POSTOP",1423,"2566","DOCUSATE SODIUM 100 MG PO CAPS",3,291,0.20449754040759,542,37509,0.0103092783505155,0.0144498653656456,0.713451515958458,288,36967,0.731289225609196
"539",741,"IP VAS GENERAL POSTOP",1423,"2567","DOCUSATE SODIUM 250 MG PO CAPS",1,179,0.125790583274772,296,17760,0.00558659217877095,0.0166666666666667,0.335195530726257,178,17464,0.38891089624702
"540",741,"IP VAS GENERAL POSTOP",1423,"4318","LACTATED RINGERS IV SOLP",5,164,0.115249472944483,135,4847,0.0304878048780488,0.0278522797606767,1.0946251129178,159,4712,0.999999999999993
"541",741,"IP VAS GENERAL POSTOP",1423,"4711","MAGNESIUM CITRATE PO SOLN",4,317,0.222768798313422,131,5481,0.0126182965299685,0.0239007480386791,0.527945673898909,313,5350,0.269768678647199
"542",741,"IP VAS GENERAL POSTOP",1423,"5002","METOCLOPRAMIDE HCL 5 MG/ML INJ SOLN",2,434,0.30498945888967,346,10128,0.00460829493087558,0.0341627172195893,0.134892517514184,432,9782,0.00119386062651741
"543",741,"IP VAS GENERAL POSTOP",1423,"5373","NALOXONE 0.4 MG/ML INJ SOLN",5,465,0.326774420238932,83,1774,0.010752688172043,0.0467869222096956,0.229822515869931,460,1691,0.000613886477919461
"544",741,"IP VAS GENERAL POSTOP",1423,"11349","SENNOSIDES 8.6 MG PO TABS",4,434,0.30498945888967,610,35793,0.00921658986175115,0.0170424384656218,0.540802296592884,430,35183,0.285340880303211
"545",741,"IP VAS GENERAL POSTOP",1423,"14113","ASPIRIN 81 MG PO TBEC",2,51,0.0358397751229796,391,18448,0.0392156862745098,0.0211947094535993,1.85025826187252,49,18057,0.685441410821198
"546",741,"IP VAS GENERAL POSTOP",1423,"14863","POTASSIUM CHLORID-D5-0.45%NACL 20 MEQ/L IV SOLP",3,113,0.0794096978215039,314,8762,0.0265486725663717,0.035836566993837,0.740826334479454,110,8448,0.78444938253605
"547",741,"IP VAS GENERAL POSTOP",1423,"16426","NS WITH POTASSIUM CHLORIDE 20 MEQ/L IV SOLP",1,38,0.0267041461700632,118,4415,0.0263157894736842,0.026727066817667,0.984611953612846,37,4297,0.999999999999842
"548",741,"IP VAS GENERAL POSTOP",1423,"25365","CEFAZOLIN IN DEXTROSE (ISO-OS) 1 GRAM/50 ML IV PGBK",2,94,0.0660576247364722,258,5335,0.0212765957446809,0.0483598875351453,0.439963714332839,92,5077,0.329377764467245
"549",741,"IP VAS GENERAL POSTOP",1423,"86533","MAGNESIUM HYDROXIDE 400 MG/5 ML PO SUSP",2,380,0.267041461700632,111,6618,0.00526315789473684,0.0167724388032638,0.313798008534851,378,6507,0.128071962356406
"550",741,"IP VAS GENERAL POSTOP",1423,"90206","SODIUM PHOSPHATES 19-7 GRAM/118 ML PR ENEM",4,265,0.186226282501757,101,3581,0.0150943396226415,0.02820441217537,0.535176536521577,261,3480,0.285350847751275
"551",741,"IP VAS GENERAL POSTOP",1423,"110872","HYDROMORPHONE 2 MG/ML INJ SYRG",1,130,0.0913562895291637,738,23934,0.00769230769230769,0.0308347956881424,0.249468417761101,129,23196,0.203948354111077
"552",741,"IP VAS GENERAL POSTOP",1423,"112586","HYDROMORPHONE 1 MG/ML INJ SYRG",1,138,0.0969782150386507,1219,33427,0.0072463768115942,0.036467526251234,0.198707660115799,137,32208,0.109043814644376
"553",741,"IP VAS GENERAL POSTOP",1423,"198509","ONDANSETRON HCL (PF) 4 MG/2 ML INJ SOLN",2,468,0.328882642304989,705,36939,0.00427350427350427,0.0190855193697718,0.223913438807056,466,36234,0.0301914699230266
"554",741,"IP VAS GENERAL POSTOP",1423,"212945","HEPARIN, PORCINE (PF) 5,000 UNIT/0.5 ML INJ SOLN",1,142,0.0997891777933942,452,13480,0.00704225352112676,0.0335311572700297,0.210021189081391,141,13028,0.12951768984696
"555",741,"IP VAS GENERAL POSTOP",1423,"236263","CEFAZOLIN IN DEXTROSE (ISO-OS) 2 GRAM/100 ML IV PGBK",2,63,0.0442726633872101,111,2584,0.0317460317460317,0.0429566563467492,0.739024739024739,61,2473,0.904874673985534
"556",742,"IP VAS GENERAL PREOP",53,"14863","POTASSIUM CHLORID-D5-0.45%NACL 20 MEQ/L IV SOLP",1,17,0.320754716981132,314,8762,0.0588235294117647,0.035836566993837,1.64143874110154,16,8448,0.999999999999312
"557",753,"IP NEU ICU ADMIT",711,"680","ASPIRIN 81 MG PO CHEW",1,12,0.0168776371308017,357,11203,0.0833333333333333,0.031866464339909,2.61507936507937,11,10846,0.847633955534062
"558",753,"IP NEU ICU ADMIT",711,"5007","METOPROLOL TARTRATE 5 MG/5 ML IV SOLN",1,1,0.00140646976090014,745,12385,1,0.0601534113847396,16.6241610738255,0,11640,0.0645241703957725
"559",753,"IP NEU ICU ADMIT",711,"10372","LABETALOL 5 MG/ML IV SOLN",1,20,0.0281293952180028,370,5898,0.05,0.0627331298745337,0.797027027027027,19,5528,0.999999999999927
"560",753,"IP NEU ICU ADMIT",711,"27838","SODIUM CHLORIDE 0.9 % 0.9 % IV SOLP",4,95,0.133614627285513,692,19620,0.0421052631578947,0.0352701325178389,1.19379373288713,91,18928,0.93505919674055
"561",753,"IP NEU ICU ADMIT",711,"78531","ATORVASTATIN 20 MG PO TABS",2,16,0.0225035161744023,60,3749,0.125,0.0160042678047479,7.81041666666667,14,3689,0.0149242488790371
"562",753,"IP NEU ICU ADMIT",711,"82384","PANTOPRAZOLE 40 MG IV SOLR",1,91,0.127988748241913,688,12925,0.010989010989011,0.0532301740812379,0.206443266036289,90,12237,0.11912324401649
"563",753,"IP NEU ICU ADMIT",711,"83628","AMLODIPINE 5 MG PO TABS",1,2,0.00281293952180028,435,12391,0.5,0.0351061254136067,14.2425287356322,1,11956,0.0991290716213317
"564",753,"IP NEU ICU ADMIT",711,"202606","FAMOTIDINE (PF) 20 MG/2 ML IV SOLN",1,14,0.019690576652602,288,4280,0.0714285714285714,0.0672897196261682,1.06150793650794,13,3992,0.999999999999999
"565",753,"IP NEU ICU ADMIT",711,"209037","ACETAMINOPHEN 650 MG/20.3 ML PO SOLN",4,103,0.144866385372714,192,8611,0.0388349514563107,0.0222970618975729,1.7417071197411,99,8419,0.428953747623454
"566",753,"IP NEU ICU ADMIT",711,"530010","NICARDIPINE IV INFUSION",9,22,0.0309423347398031,257,676,0.409090909090909,0.380177514792899,1.07605235231694,13,419,0.9587150767995
"567",755,"IP NEU GENERAL WARD ADMIT",3072,"101","ACETAMINOPHEN 325 MG PO TABS",8,652,0.212239583333333,981,42092,0.0122699386503067,0.0233060914187969,0.526469171935486,644,41111,0.0838438781195414
"568",755,"IP NEU GENERAL WARD ADMIT",3072,"102","ACETAMINOPHEN 500 MG PO TABS",2,6,0.001953125,392,15968,0.333333333333333,0.0245490981963928,13.578231292517,4,15576,0.000371810366111544
"569",755,"IP NEU GENERAL WARD ADMIT",3072,"681","ASPIRIN 325 MG PO TABS",1,5,0.00162760416666667,303,7114,0.2,0.0425920719707619,4.6957095709571,4,6811,0.52614532361672
"570",755,"IP NEU GENERAL WARD ADMIT",3072,"2365","DEXTROSE 50 % IN WATER (D50W) IV SYRG",1,94,0.0305989583333333,134,3551,0.0106382978723404,0.0377358490566038,0.281914893617021,93,3417,0.272895388249547
"571",755,"IP NEU GENERAL WARD ADMIT",3072,"2566","DOCUSATE SODIUM 100 MG PO CAPS",2,296,0.0963541666666667,542,37509,0.00675675675675676,0.0144498653656456,0.467599980053855,294,36967,0.388661526656623
"572",755,"IP NEU GENERAL WARD ADMIT",3072,"11349","SENNOSIDES 8.6 MG PO TABS",3,199,0.0647786458333333,610,35793,0.0150753768844221,0.0170424384656218,0.884578630859214,196,35183,0.99999999999888
"573",755,"IP NEU GENERAL WARD ADMIT",3072,"16050","GLUCOSE 4 GRAM PO CHEW",1,95,0.0309244791666667,17,1600,0.0105263157894737,0.010625,0.990712074303405,94,1583,0.999999999999999
"574",755,"IP NEU GENERAL WARD ADMIT",3072,"16426","NS WITH POTASSIUM CHLORIDE 20 MEQ/L IV SOLP",3,168,0.0546875,118,4415,0.0178571428571429,0.026727066817667,0.668129539951574,165,4297,0.646470202194337
"575",755,"IP NEU GENERAL WARD ADMIT",3072,"77545","ATORVASTATIN 40 MG PO TABS",1,103,0.0335286458333333,159,9613,0.00970873786407767,0.0165401019452824,0.586981742687916,102,9454,0.878639999658873
"576",755,"IP NEU GENERAL WARD ADMIT",3072,"78531","ATORVASTATIN 20 MG PO TABS",2,5,0.00162760416666667,60,3749,0.4,0.0160042678047479,24.9933333333333,3,3689,6.45645617120291e-07
"577",755,"IP NEU GENERAL WARD ADMIT",3072,"78748","INSULIN GLARGINE 100 UNIT/ML SC SOLN",1,19,0.00618489583333333,348,8601,0.0526315789473684,0.0404604115800488,1.3008166969147,18,8253,0.999999999999695
"578",755,"IP NEU GENERAL WARD ADMIT",3072,"79507","ATORVASTATIN 10 MG PO TABS",1,13,0.00423177083333333,96,5116,0.0769230769230769,0.0187646598905395,4.09935897435897,12,5020,0.604371300142608
"579",755,"IP NEU GENERAL WARD ADMIT",3072,"88045","SIMVASTATIN 20 MG PO TABS",1,3,0.0009765625,56,5146,0.333333333333333,0.0108822386319471,30.6309523809524,2,5090,0.00998091480525756
"580",755,"IP NEU GENERAL WARD ADMIT",3072,"89742","INSULIN NPH HUMAN RECOMB 100 UNIT/ML SC SUSP",2,13,0.00423177083333333,703,13345,0.153846153846154,0.0526789059572874,2.92045081518766,11,12642,0.312454608462987
"581",755,"IP NEU GENERAL WARD ADMIT",3072,"92835","INSULIN LISPRO 100 UNIT/ML SC SOLN",5,107,0.0348307291666667,516,10567,0.0467289719626168,0.0488312671524558,0.956947764978628,102,10051,0.999999999999998
"582",755,"IP NEU GENERAL WARD ADMIT",3072,"110892","ENOXAPARIN 40 MG/0.4 ML SC SYRG",16,337,0.109700520833333,499,13896,0.0474777448071217,0.0359096142774899,1.32214577522999,321,13397,0.329054261035644
"583",758,"RETIRED IP NEU ICU INTRACEREBRAL HEMORRHAGE",152,"81421","ESMOLOL IN NACL (ISO-OSM) 2,500 MG/250 ML (10 MG/ML) IV SOLP",1,5,0.0328947368421053,72,1479,0.2,0.0486815415821501,4.10833333333333,4,1407,0.598737948541823
"584",758,"RETIRED IP NEU ICU INTRACEREBRAL HEMORRHAGE",152,"82384","PANTOPRAZOLE 40 MG IV SOLR",1,29,0.190789473684211,688,12925,0.0344827586206897,0.0532301740812379,0.647804731355253,28,12237,0.971941949244833
"585",758,"RETIRED IP NEU ICU INTRACEREBRAL HEMORRHAGE",152,"209037","ACETAMINOPHEN 650 MG/20.3 ML PO SOLN",3,35,0.230263157894737,192,8611,0.0857142857142857,0.0222970618975729,3.84419642857143,32,8419,0.0510109151962715
"586",758,"RETIRED IP NEU ICU INTRACEREBRAL HEMORRHAGE",152,"530010","NICARDIPINE IV INFUSION",8,15,0.0986842105263158,257,676,0.533333333333333,0.380177514792899,1.40285343709468,7,419,0.348159375247847
"587",759,"IP NEU HYPOTHERMIA AFTER CARDIAC ARREST PROTOCOL",381,"11634","VECURONIUM BROMIDE 10 MG IV SOLR",4,78,0.204724409448819,6,198,0.0512820512820513,0.0303030303030303,1.69230769230769,74,192,0.629727309070216
"588",759,"IP NEU HYPOTHERMIA AFTER CARDIAC ARREST PROTOCOL",381,"530003","FENTANYL  10 MCG/ML IV INFUSION",5,46,0.120734908136483,51,585,0.108695652173913,0.0871794871794872,1.24680306905371,41,534,0.822088869287681
"589",759,"IP NEU HYPOTHERMIA AFTER CARDIAC ARREST PROTOCOL",381,"530004","MIDAZOLAM 50 MG IN D5W 100 ML IV INFUSION",7,76,0.199475065616798,65,1105,0.0921052631578947,0.0588235294117647,1.56578947368421,69,1040,0.354884627763689
"590",759,"IP NEU HYPOTHERMIA AFTER CARDIAC ARREST PROTOCOL",381,"530007","VECURONIUM IV INFUSION",10,80,0.20997375328084,4,99,0.125,0.0404040404040404,3.09375,70,95,0.0694060958177766
"591",759,"IP NEU HYPOTHERMIA AFTER CARDIAC ARREST PROTOCOL",381,"540102","NS IV BOLUS",5,75,0.196850393700787,2225,80957,0.0666666666666667,0.0274837259285794,2.42567790262172,70,78732,0.0853929283371095
"592",759,"IP NEU HYPOTHERMIA AFTER CARDIAC ARREST PROTOCOL",381,"540638","FENTANYL 50 MCG/ML IV INFUSION",1,28,0.073490813648294,23,146,0.0357142857142857,0.157534246575342,0.226708074534162,27,123,0.157591069616907
"593",761,"RETIRED IP NEU STROKE ISCHEMIC ELEVATED ICP",4,"4750","MANNITOL 25 % 25 % IV SOLN",1,1,0.25,21,64,1,0.328125,3.04761904761905,0,43,0.730815320888868
"594",761,"RETIRED IP NEU STROKE ISCHEMIC ELEVATED ICP",4,"4750","MANNITOL 25 % 25 % IV SOLN",1,1,0.25,21,64,1,0.328125,3.04761904761905,0,43,0.730815320888868
"595",765,"IP NEU ICU TRAUMATIC BRAIN INJURY PROTOCOL",37,"7322","SODIUM CHLORIDE 4 MEQ/ML IV SOLP",2,2,0.0540540540540541,22,515,1,0.0427184466019417,23.4090909090909,0,493,2.15425542810016e-06
"596",765,"IP NEU ICU TRAUMATIC BRAIN INJURY PROTOCOL",37,"16426","NS WITH POTASSIUM CHLORIDE 20 MEQ/L IV SOLP",1,9,0.243243243243243,118,4415,0.111111111111111,0.026727066817667,4.15725047080979,8,4297,0.594781221103919
"597",765,"IP NEU ICU TRAUMATIC BRAIN INJURY PROTOCOL",37,"82384","PANTOPRAZOLE 40 MG IV SOLR",1,11,0.297297297297297,688,12925,0.0909090909090909,0.0532301740812379,1.7078488372093,10,12237,0.999999999999995
"598",765,"IP NEU ICU TRAUMATIC BRAIN INJURY PROTOCOL",37,"530025","DEXMEDETOMIDINE IV INFUSION",1,1,0.027027027027027,530,2902,1,0.18263266712612,5.47547169811321,0,2372,0.412022185201503
"599",766,"IP RAD NEURORADIOLOGY POST-PROCEDURE",1475,"101","ACETAMINOPHEN 325 MG PO TABS",6,193,0.130847457627119,981,42092,0.0310880829015544,0.0233060914187969,1.33390375687281,187,41111,0.634445666173618
"600",766,"IP RAD NEURORADIOLOGY POST-PROCEDURE",1475,"34505","HYDROCODONE-ACETAMINOPHEN 5-325 MG PO TABS",9,168,0.113898305084746,603,24164,0.0535714285714286,0.0249544777354743,2.14676616915423,159,23561,0.034569256466848
"601",766,"IP RAD NEURORADIOLOGY POST-PROCEDURE",1475,"198509","ONDANSETRON HCL (PF) 4 MG/2 ML INJ SOLN",6,188,0.127457627118644,705,36939,0.0319148936170213,0.0190855193697718,1.67220461747397,182,36234,0.310826157485817
"602",775,"IP SUR TRAUMA SURGICAL INTERVENTION",125,"101","ACETAMINOPHEN 325 MG PO TABS",1,28,0.224,981,42092,0.0357142857142857,0.0233060914187969,1.53240133974079,27,41111,0.999999999997374
"603",775,"IP SUR TRAUMA SURGICAL INTERVENTION",125,"14863","POTASSIUM CHLORID-D5-0.45%NACL 20 MEQ/L IV SOLP",1,16,0.128,314,8762,0.0625,0.035836566993837,1.74402866242038,15,8448,0.999999999999738
"604",778,"RETIRED IP SUR APPENDECTOMY POSTOP",15,"198509","ONDANSETRON HCL (PF) 4 MG/2 ML INJ SOLN",1,5,0.333333333333333,705,36939,0.2,0.0190855193697718,10.4791489361702,4,36234,0.186434590271818
"605",792,"IP ICU GI BLEED",164,"81505","CIPROFLOXACIN IN D5W 400 MG/200 ML IV PGBK",1,4,0.024390243902439,242,3682,0.25,0.0657251493753395,3.80371900826446,3,3440,0.63380464589299
"606",792,"IP ICU GI BLEED",164,"82384","PANTOPRAZOLE 40 MG IV SOLR",1,33,0.201219512195122,688,12925,0.0303030303030303,0.0532301740812379,0.569282945736434,32,12237,0.843176527768213
"607",792,"IP ICU GI BLEED",164,"96559","PIPERACILLIN-TAZOBACTAM-DEXTRS 3.375 GRAM/50 ML IV PGBK",1,1,0.00609756097560976,1067,10067,1,0.105989867885169,9.4348641049672,0,9000,0.200796619232221
"608",792,"IP ICU GI BLEED",164,"530014","PANTOPRAZOLE 0.8 MG/ML IV INFUSION",1,43,0.26219512195122,72,1751,0.0232558139534884,0.0411193603655054,0.565568475452196,42,1679,0.845313678607907
"609",792,"IP ICU GI BLEED",164,"530016","OCTREOTIDE 10 MCG/ML IV INFUSION",1,20,0.121951219512195,29,929,0.05,0.031216361679225,1.60172413793103,19,900,0.999999999999992
"610",798,"IP SUR GENERAL PREOP",664,"1445","CEFAZOLIN 1 GRAM INJ SOLR",14,296,0.44578313253012,47,571,0.0472972972972973,0.0823117338003503,0.574611845888442,282,524,0.0764714359579744
"611",798,"IP SUR GENERAL PREOP",664,"8442","VANCOMYCIN 1,000 MG IV SOLR",1,12,0.0180722891566265,248,2879,0.0833333333333333,0.0861410211879125,0.967405913978495,11,2631,0.999999999999978
"612",801,"IP SUR OR GENERAL POSTOP",3021,"5002","METOCLOPRAMIDE HCL 5 MG/ML INJ SOLN",5,930,0.307845084409136,346,10128,0.00537634408602151,0.0341627172195893,0.157374603766549,925,9782,2.67199896098858e-06
"613",801,"IP SUR OR GENERAL POSTOP",3021,"5373","NALOXONE 0.4 MG/ML INJ SOLN",3,22,0.00728235683548494,83,1774,0.136363636363636,0.0467869222096956,2.91456736035049,19,1691,0.146138981754399
"614",801,"IP SUR OR GENERAL POSTOP",3021,"14863","POTASSIUM CHLORID-D5-0.45%NACL 20 MEQ/L IV SOLP",2,247,0.0817610062893082,314,8762,0.00809716599190283,0.035836566993837,0.225947033188066,245,8448,0.0306458565876691
"615",801,"IP SUR OR GENERAL POSTOP",3021,"15861","D5 %-0.45 % SODIUM CHLORIDE IV SOLP",1,53,0.0175438596491228,158,4300,0.0188679245283019,0.0367441860465116,0.513494148555051,52,4142,0.748106104570498
"616",801,"IP SUR OR GENERAL POSTOP",3021,"16426","NS WITH POTASSIUM CHLORIDE 20 MEQ/L IV SOLP",1,38,0.0125786163522013,118,4415,0.0263157894736842,0.026727066817667,0.984611953612846,37,4297,0.999999999999842
"617",801,"IP SUR OR GENERAL POSTOP",3021,"27838","SODIUM CHLORIDE 0.9 % 0.9 % IV SOLP",1,190,0.0628930817610063,692,19620,0.00526315789473684,0.0352701325178389,0.149224216610891,189,18928,0.041155150877909
"618",801,"IP SUR OR GENERAL POSTOP",3021,"34505","HYDROCODONE-ACETAMINOPHEN 5-325 MG PO TABS",5,156,0.0516385302879841,603,24164,0.032051282051282,0.0249544777354743,1.2843900157333,151,23561,0.757561974670018
"619",801,"IP SUR OR GENERAL POSTOP",3021,"96559","PIPERACILLIN-TAZOBACTAM-DEXTRS 3.375 GRAM/50 ML IV PGBK",7,40,0.0132406487917908,1067,10067,0.175,0.105989867885169,1.65110121836926,33,9000,0.247507366178126
"620",801,"IP SUR OR GENERAL POSTOP",3021,"110892","ENOXAPARIN 40 MG/0.4 ML SC SYRG",2,76,0.0251572327044025,499,13896,0.0263157894736842,0.0359096142774899,0.732834089231094,74,13397,0.889221602839886
"621",801,"IP SUR OR GENERAL POSTOP",3021,"112564","MORPHINE 2 MG/ML INJ SYRG",2,31,0.0102615028136379,276,6156,0.0645161290322581,0.0448343079922027,1.43899018232819,29,5880,0.925846813009105
"622",801,"IP SUR OR GENERAL POSTOP",3021,"112586","HYDROMORPHONE 1 MG/ML INJ SYRG",3,126,0.041708043694141,1219,33427,0.0238095238095238,0.036467526251234,0.652896597523341,123,32208,0.603888963986084
"623",801,"IP SUR OR GENERAL POSTOP",3021,"198509","ONDANSETRON HCL (PF) 4 MG/2 ML INJ SOLN",9,1003,0.332009268454154,705,36939,0.00897308075772682,0.0190855193697718,0.470151248382512,994,36234,0.0272586764460906
"624",801,"IP SUR OR GENERAL POSTOP",3021,"212945","HEPARIN, PORCINE (PF) 5,000 UNIT/0.5 ML INJ SOLN",6,600,0.198609731876862,452,13480,0.01,0.0335311572700297,0.298230088495575,594,13028,0.00220187478585295
"625",801,"IP SUR OR GENERAL POSTOP",3021,"540965","PIPERACILLIN-TAZOBACTAM 3.375 GRAM/50 ML MINI-BAG PLUS",1,10,0.0033101621979477,235,4195,0.1,0.0560190703218117,1.78510638297872,9,3960,0.999999999999757
"626",801,"IP SUR OR GENERAL POSTOP",3021,"541104","CEFOXITIN 1 GRAM/50 ML MINI-BAG PLUS",1,33,0.0109235352532274,9,214,0.0303030303030303,0.0420560747663551,0.720538720538721,32,205,0.999999999999999
"627",801,"IP SUR OR GENERAL POSTOP",3021,"541271","PIPERACILLIN-TAZOBACTAM 3.375 GRAM/50 ML IVPB EXTENDED INFUSION",3,36,0.0119165839126117,466,8270,0.0833333333333333,0.0563482466747279,1.47889842632332,33,7804,0.735270767075586
"628",805,"IP SUR GENERAL ADMIT",15690,"101","ACETAMINOPHEN 325 MG PO TABS",24,1501,0.095666029318037,981,42092,0.0159893404397069,0.0233060914187969,0.686058427918595,1477,41111,0.0769710423238707
"629",805,"IP SUR GENERAL ADMIT",15690,"102","ACETAMINOPHEN 500 MG PO TABS",4,281,0.0179094964945825,392,15968,0.0142348754448399,0.0245490981963928,0.579853293630619,277,15576,0.359453104807696
"630",805,"IP SUR GENERAL ADMIT",15690,"326","ALPRAZOLAM 1 MG PO TABS",1,2,0.000127469725940089,15,450,0.5,0.0333333333333333,15,1,435,0.0997507862408433
"631",805,"IP SUR GENERAL ADMIT",15690,"1080","BISACODYL 10 MG PR SUPP",3,372,0.0237093690248566,344,22442,0.00806451612903226,0.0153284021031994,0.526115903975994,369,22098,0.356634648120451
"632",805,"IP SUR GENERAL ADMIT",15690,"2511","DIPHENHYDRAMINE HCL 12.5 MG/5 ML PO ELIX",1,43,0.00274059910771192,57,714,0.0232558139534884,0.0798319327731092,0.291309669522644,42,657,0.289404662178956
"633",805,"IP SUR GENERAL ADMIT",15690,"2569","DOCUSATE SODIUM 50 MG/5 ML PO LIQD",7,385,0.0245379222434672,170,7328,0.0181818181818182,0.0231986899563319,0.783743315508021,378,7158,0.641079245614626
"634",805,"IP SUR GENERAL ADMIT",15690,"3758","HYDROMORPHONE 2 MG/ML INJ SOLN",1,7,0.000446144040790312,2,86,0.142857142857143,0.0232558139534884,6.14285714285714,6,84,0.541888145731545
"635",805,"IP SUR GENERAL ADMIT",15690,"3843","IBUPROFEN 400 MG PO TABS",1,40,0.00254939451880178,148,4216,0.025,0.0351043643263757,0.712162162162162,39,4068,0.999999999999999
"636",805,"IP SUR GENERAL ADMIT",15690,"4573","LORAZEPAM 1 MG PO TABS",1,9,0.000573613766730402,337,8494,0.111111111111111,0.0396750647515894,2.80052753049786,8,8157,0.808147579013301
"637",805,"IP SUR GENERAL ADMIT",15690,"4711","MAGNESIUM CITRATE PO SOLN",1,33,0.00210325047801147,131,5481,0.0303030303030303,0.0239007480386791,1.26786953504511,32,5350,0.999999999999987
"638",805,"IP SUR GENERAL ADMIT",15690,"5002","METOCLOPRAMIDE HCL 5 MG/ML INJ SOLN",11,1521,0.0969407265774379,346,10128,0.00723208415516108,0.0341627172195893,0.211695226368414,1510,9782,2.11670270319495e-08
"639",805,"IP SUR GENERAL ADMIT",15690,"5007","METOPROLOL TARTRATE 5 MG/5 ML IV SOLN",6,207,0.0131931166347992,745,12385,0.0289855072463768,0.0601534113847396,0.481859741270304,201,11640,0.083641068738824
"640",805,"IP SUR GENERAL ADMIT",15690,"5009","METOPROLOL TARTRATE 50 MG PO TABS",1,3,0.000191204588910134,199,5315,0.333333333333333,0.0374412041392286,8.90284757118928,2,5116,0.239869977722474
"641",805,"IP SUR GENERAL ADMIT",15690,"5018","METRONIDAZOLE IN NACL (ISO-OS) 500 MG/100 ML IV PGBK",6,183,0.0116634799235182,223,3847,0.0327868852459016,0.0579672472056148,0.565610527089613,177,3624,0.202599740063018
"642",805,"IP SUR GENERAL ADMIT",15690,"6618","PROMETHAZINE 25 MG/ML INJ SOLN",1,73,0.00465264499681326,289,5149,0.0136986301369863,0.056127403379297,0.244063136938901,72,4860,0.188695724494378
"643",805,"IP SUR GENERAL ADMIT",15690,"10011","FAMOTIDINE 20 MG PO TABS",1,50,0.00318674314850223,472,16960,0.02,0.0278301886792453,0.71864406779661,49,16488,0.999999999999992
"644",805,"IP SUR GENERAL ADMIT",15690,"14863","POTASSIUM CHLORID-D5-0.45%NACL 20 MEQ/L IV SOLP",78,3566,0.227278521351179,314,8762,0.0218732473359506,0.035836566993837,0.610361124705731,3488,8448,7.82160731063692e-05
"645",805,"IP SUR GENERAL ADMIT",15690,"15861","D5 %-0.45 % SODIUM CHLORIDE IV SOLP",3,136,0.00866794136392607,158,4300,0.0220588235294118,0.0367441860465116,0.600335070737156,133,4142,0.503668006870966
"646",805,"IP SUR GENERAL ADMIT",15690,"16426","NS WITH POTASSIUM CHLORIDE 20 MEQ/L IV SOLP",6,179,0.011408540471638,118,4415,0.0335195530726257,0.026727066817667,1.25414260013256,173,4297,0.753142312638744
"647",805,"IP SUR GENERAL ADMIT",15690,"25365","CEFAZOLIN IN DEXTROSE (ISO-OS) 1 GRAM/50 ML IV PGBK",6,325,0.0207138304652645,258,5335,0.0184615384615385,0.0483598875351453,0.38175313059034,319,5077,0.018971134437389
"648",805,"IP SUR GENERAL ADMIT",15690,"27838","SODIUM CHLORIDE 0.9 % 0.9 % IV SOLP",17,607,0.0386870618228171,692,19620,0.028006589785832,0.0352701325178389,0.79405966993934,590,18928,0.39738961652896
"649",805,"IP SUR GENERAL ADMIT",15690,"81505","CIPROFLOXACIN IN D5W 400 MG/200 ML IV PGBK",7,164,0.0104525175270873,242,3682,0.0426829268292683,0.0657251493753395,0.649415440435396,157,3440,0.31193266711288
"650",805,"IP SUR GENERAL ADMIT",15690,"82384","PANTOPRAZOLE 40 MG IV SOLR",25,1107,0.0705544933078394,688,12925,0.022583559168925,0.0532301740812379,0.424262357933657,1082,12237,1.16114060225011e-05
"651",805,"IP SUR GENERAL ADMIT",15690,"86533","MAGNESIUM HYDROXIDE 400 MG/5 ML PO SUSP",1,100,0.00637348629700446,111,6618,0.01,0.0167724388032638,0.596216216216216,99,6507,0.895348088274773
"652",805,"IP SUR GENERAL ADMIT",15690,"88043","PANTOPRAZOLE 40 MG PO TBEC",5,184,0.0117272147864882,624,31884,0.0271739130434783,0.0195709446744449,1.38848244147157,179,31260,0.634788866146878
"653",805,"IP SUR GENERAL ADMIT",15690,"96559","PIPERACILLIN-TAZOBACTAM-DEXTRS 3.375 GRAM/50 ML IV PGBK",115,441,0.0281070745697897,1067,10067,0.260770975056689,0.105989867885169,2.46033871217965,326,9000,1.65019718732282e-23
"654",805,"IP SUR GENERAL ADMIT",15690,"110872","HYDROMORPHONE 2 MG/ML INJ SYRG",42,1701,0.108413001912046,738,23934,0.0246913580246914,0.0308347956881424,0.800762822443039,1659,23196,0.176265783746354
"655",805,"IP SUR GENERAL ADMIT",15690,"110888","ENOXAPARIN 30 MG/0.3 ML SC SYRG",3,20,0.00127469725940089,73,1394,0.15,0.0523672883787661,2.86438356164384,17,1321,0.154723220886906
"656",805,"IP SUR GENERAL ADMIT",15690,"110889","ENOXAPARIN 60 MG/0.6 ML SC SYRG",2,4,0.000254939451880178,119,2159,0.5,0.0551181102362205,9.07142857142857,2,2040,0.00544722030967489
"657",805,"IP SUR GENERAL ADMIT",15690,"110892","ENOXAPARIN 40 MG/0.4 ML SC SYRG",12,359,0.022880815806246,499,13896,0.0334261838440111,0.0359096142774899,0.930842185764286,347,13397,0.915480009551411
"658",805,"IP SUR GENERAL ADMIT",15690,"112564","MORPHINE 2 MG/ML INJ SYRG",4,267,0.0170172084130019,276,6156,0.0149812734082397,0.0448343079922027,0.334147532975086,263,5880,0.0288356806772582
"659",805,"IP SUR GENERAL ADMIT",15690,"112586","HYDROMORPHONE 1 MG/ML INJ SYRG",33,1017,0.0648183556405354,1219,33427,0.0324483775811209,0.036467526251234,0.889788283350394,984,32208,0.555447962197049
"660",805,"IP SUR GENERAL ADMIT",15690,"124216","VANCOMYCIN IN D5W 1 GRAM/200 ML IV PGBK",21,144,0.00917782026768642,1951,16917,0.145833333333333,0.115327776792576,1.26451178882624,123,14966,0.31286895629104
"661",805,"IP SUR GENERAL ADMIT",15690,"124873","SENNA LEAF EXTRACT 176 MG/5 ML PO SYRP",3,182,0.0115997450605481,90,4112,0.0164835164835165,0.0218871595330739,0.753113553113553,179,4022,0.81817798394437
"662",805,"IP SUR GENERAL ADMIT",15690,"198509","ONDANSETRON HCL (PF) 4 MG/2 ML INJ SOLN",42,4590,0.292543021032505,705,36939,0.00915032679738562,0.0190855193697718,0.479438186622167,4548,36234,2.38661362893501e-06
"663",805,"IP SUR GENERAL ADMIT",15690,"200439","HYDROMORPHONE (PF) 2 MG/ML INJ SOLN",2,185,0.0117909496494583,142,3356,0.0108108108108108,0.0423122765196663,0.255500570993529,183,3214,0.0547737347814238
"664",805,"IP SUR GENERAL ADMIT",15690,"202606","FAMOTIDINE (PF) 20 MG/2 ML IV SOLN",19,154,0.00981516889738687,288,4280,0.123376623376623,0.0672897196261682,1.83351370851371,135,3992,0.0113352184638885
"665",805,"IP SUR GENERAL ADMIT",15690,"212945","HEPARIN, PORCINE (PF) 5,000 UNIT/0.5 ML INJ SOLN",32,2268,0.144550669216061,452,13480,0.0141093474426808,0.0335311572700297,0.420783193644551,2236,13028,9.96571133614345e-07
"666",805,"IP SUR GENERAL ADMIT",15690,"540102","NS IV BOLUS",2,44,0.00280433397068196,2225,80957,0.0454545454545455,0.0274837259285794,1.65387129724208,42,78732,0.788925979790686
"667",805,"IP SUR GENERAL ADMIT",15690,"540301","POTASSIUM CHLORIDE ORAL SCALE",2,95,0.00605481198215424,105,3653,0.0210526315789474,0.0287434984943882,0.732431077694236,93,3548,0.894694418522955
"668",805,"IP SUR GENERAL ADMIT",15690,"540302","POTASSIUM CHLORIDE IV SCALE",2,247,0.015742511153601,150,4660,0.00809716599190283,0.0321888412017167,0.251551956815115,245,4510,0.0522252470200412
"669",805,"IP SUR GENERAL ADMIT",15690,"540773","PIPERACILLIN-TAZOBACTAM (ZOSYN) 3.375 GRAM IN DEXTROSE IVPB",1,42,0.00267686424474187,2,9,0.0238095238095238,0.222222222222222,0.107142857142857,41,7,0.129727787606415
"670",805,"IP SUR GENERAL ADMIT",15690,"540965","PIPERACILLIN-TAZOBACTAM 3.375 GRAM/50 ML MINI-BAG PLUS",2,67,0.00427023581899299,235,4195,0.0298507462686567,0.0560190703218117,0.532867577008574,65,3960,0.510125714553768
"671",805,"IP SUR GENERAL ADMIT",15690,"541048","HYDROMORPHONE VARIABLE DOSE INJECTION",7,389,0.0247928616953474,104,5739,0.0179948586118252,0.0181216239763025,0.993004745896777,382,5635,0.999999999999991
"672",805,"IP SUR GENERAL ADMIT",15690,"541061","VANCOMYCIN PER PHARMACY PROTOCOL",2,75,0.00478011472275335,239,5475,0.0266666666666667,0.0436529680365297,0.610878661087866,73,5236,0.665976695646873
"673",805,"IP SUR GENERAL ADMIT",15690,"541081","PIPERACILLIN-TAZOBACTAM 3.375 GRAM/50 ML MINI-BAG PLUS EXTENDED INF",10,141,0.00898661567877629,9,216,0.0709219858156028,0.0416666666666667,1.70212765957447,131,207,0.335746587401922
"674",805,"IP SUR GENERAL ADMIT",15690,"541104","CEFOXITIN 1 GRAM/50 ML MINI-BAG PLUS",3,88,0.00560866794136393,9,214,0.0340909090909091,0.0420560747663551,0.810606060606061,85,205,0.999999999999993
"675",805,"IP SUR GENERAL ADMIT",15690,"541271","PIPERACILLIN-TAZOBACTAM 3.375 GRAM/50 ML IVPB EXTENDED INFUSION",13,364,0.0231994901210962,466,8270,0.0357142857142857,0.0563482466747279,0.633813611281422,351,7804,0.117317912639822
"676",805,"IP SUR GENERAL ADMIT",15690,"541273","PIPERACILLIN-TAZOBACTAM 4.5 GRAM/100 ML IVPB EXTENDED INFUSION",1,9,0.000573613766730402,148,1260,0.111111111111111,0.117460317460317,0.945945945945946,8,1112,0.999999999999997
"677",805,"IP SUR GENERAL ADMIT",15690,"9000000","ZZZ IMS TEMPLATE",1,1,6.37348629700446e-05,1035,28824,1,0.0359075770191507,27.8492753623188,0,27789,0.012664547841265
"678",806,"IP ICU SUR/TRAUMA  ADMIT",7652,"101","ACETAMINOPHEN 325 MG PO TABS",7,241,0.031495033978045,981,42092,0.029045643153527,0.0233060914187969,1.24626830949873,234,41111,0.707997828671172
"679",806,"IP ICU SUR/TRAUMA  ADMIT",7652,"1080","BISACODYL 10 MG PR SUPP",1,113,0.0147673810768427,344,22442,0.00884955752212389,0.0153284021031994,0.577330726486932,112,22098,0.860652328009889
"680",806,"IP ICU SUR/TRAUMA  ADMIT",7652,"2566","DOCUSATE SODIUM 100 MG PO CAPS",8,253,0.0330632514375327,542,37509,0.0316205533596838,0.0144498653656456,2.18829397780144,245,36967,0.0445591219633671
"681",806,"IP ICU SUR/TRAUMA  ADMIT",7652,"2567","DOCUSATE SODIUM 250 MG PO CAPS",1,49,0.00640355462624151,296,17760,0.0204081632653061,0.0166666666666667,1.22448979591837,48,17464,0.999999999999984
"682",806,"IP ICU SUR/TRAUMA  ADMIT",7652,"4318","LACTATED RINGERS IV SOLP",11,315,0.0411657083115525,135,4847,0.0349206349206349,0.0278522797606767,1.25378012933568,304,4712,0.576911169444291
"683",806,"IP ICU SUR/TRAUMA  ADMIT",7652,"5007","METOPROLOL TARTRATE 5 MG/5 ML IV SOLN",3,82,0.0107161526398327,745,12385,0.0365853658536585,0.0601534113847396,0.608201014896055,79,11640,0.50769563473753
"684",806,"IP ICU SUR/TRAUMA  ADMIT",7652,"5373","NALOXONE 0.4 MG/ML INJ SOLN",1,126,0.016466283324621,83,1774,0.00793650793650794,0.0467869222096956,0.169630904570664,125,1691,0.067900590642174
"685",806,"IP ICU SUR/TRAUMA  ADMIT",7652,"6432","POTASSIUM CHLORIDE 20 MEQ/15 ML PO LIQD",11,40,0.00522739153162572,425,8090,0.275,0.0525339925834363,5.23470588235294,29,7665,4.1451540235663e-09
"686",806,"IP ICU SUR/TRAUMA  ADMIT",7652,"7318","SODIUM CHLORIDE 0.45 % 0.45 % IV SOLP",2,17,0.00222164140094093,51,783,0.117647058823529,0.0651340996168582,1.80622837370242,15,732,0.712579435190513
"687",806,"IP ICU SUR/TRAUMA  ADMIT",7652,"9516","CHLORHEXIDINE GLUCONATE 0.12 % MM MWSH",7,313,0.0409043387349712,89,4372,0.0223642172523962,0.0203568161024703,1.09861076210647,306,4283,0.971554441551882
"688",806,"IP ICU SUR/TRAUMA  ADMIT",7652,"9626","CLINDAMYCIN IN 5 % DEXTROSE 600 MG/50 ML IV PGBK",3,16,0.00209095661265029,70,1432,0.1875,0.0488826815642458,3.83571428571429,13,1362,0.0516990858450319
"689",806,"IP ICU SUR/TRAUMA  ADMIT",7652,"9627","CLINDAMYCIN IN DEXTROSE 5% 900 MG/50 ML IV PGBK",1,6,0.000784108729743858,29,474,0.166666666666667,0.0611814345991561,2.72413793103448,5,445,0.831991098086384
"690",806,"IP ICU SUR/TRAUMA  ADMIT",7652,"10011","FAMOTIDINE 20 MG PO TABS",1,8,0.00104547830632514,472,16960,0.125,0.0278301886792453,4.49152542372881,7,16488,0.551814556720466
"691",806,"IP ICU SUR/TRAUMA  ADMIT",7652,"10372","LABETALOL 5 MG/ML IV SOLN",3,114,0.0148980658651333,370,5898,0.0263157894736842,0.0627331298745337,0.419487908961593,111,5528,0.161363279740659
"692",806,"IP ICU SUR/TRAUMA  ADMIT",7652,"10467","LORAZEPAM 2 MG/ML INJ SOLN",1,9,0.00117616309461579,749,20621,0.111111111111111,0.0363221958197954,3.05904168520991,8,19872,0.758220717101787
"693",806,"IP ICU SUR/TRAUMA  ADMIT",7652,"10607","MIDAZOLAM 1 MG/ML INJ SOLN",1,33,0.00431259801359122,155,5616,0.0303030303030303,0.0275997150997151,1.09794721407625,32,5461,0.999999999999999
"694",806,"IP ICU SUR/TRAUMA  ADMIT",7652,"11150","PROPOFOL 10 MG/ML IV EMUL",8,87,0.0113695765812859,135,3592,0.0919540229885057,0.0375835189309577,2.44665815240528,79,3457,0.0207833291554443
"695",806,"IP ICU SUR/TRAUMA  ADMIT",7652,"11349","SENNOSIDES 8.6 MG PO TABS",5,191,0.0249607945635128,610,35793,0.0261780104712042,0.0170424384656218,1.53604840786199,186,35183,0.489154735355037
"696",806,"IP ICU SUR/TRAUMA  ADMIT",7652,"14858","D5-NS WITH POTASSIUM CHLORIDE 20 MEQ/L IV SOLP",1,40,0.00522739153162572,58,2031,0.025,0.0285573609059577,0.875431034482759,39,1973,1
"697",806,"IP ICU SUR/TRAUMA  ADMIT",7652,"14863","POTASSIUM CHLORID-D5-0.45%NACL 20 MEQ/L IV SOLP",9,177,0.0231312075274438,314,8762,0.0508474576271186,0.035836566993837,1.41887077620641,168,8448,0.391966511725676
"698",806,"IP ICU SUR/TRAUMA  ADMIT",7652,"15861","D5 %-0.45 % SODIUM CHLORIDE IV SOLP",6,124,0.0162049137480397,158,4300,0.0483870967741935,0.0367441860465116,1.31686402613312,118,4142,0.663219124583502
"699",806,"IP ICU SUR/TRAUMA  ADMIT",7652,"15882","D5 % AND 0.9 % SODIUM CHLORIDE IV SOLP",2,79,0.0103240982749608,137,3533,0.0253164556962025,0.0387772431361449,0.652868890326157,77,3396,0.749394730419365
"700",806,"IP ICU SUR/TRAUMA  ADMIT",7652,"16426","NS WITH POTASSIUM CHLORIDE 20 MEQ/L IV SOLP",2,55,0.00718766335598536,118,4415,0.0363636363636364,0.026727066817667,1.36055469953775,53,4297,0.984268395097246
"701",806,"IP ICU SUR/TRAUMA  ADMIT",7652,"25365","CEFAZOLIN IN DEXTROSE (ISO-OS) 1 GRAM/50 ML IV PGBK",1,31,0.00405122843700993,258,5335,0.032258064516129,0.0483598875351453,0.66704176044011,30,5077,0.999999999999986
"702",806,"IP ICU SUR/TRAUMA  ADMIT",7652,"25424","POLYETHYLENE GLYCOL 3350 17 GRAM PO PWPK",1,174,0.0227391531625719,712,36910,0.00574712643678161,0.0192901652668653,0.297930388738215,173,36198,0.307161847496578
"703",806,"IP ICU SUR/TRAUMA  ADMIT",7652,"27838","SODIUM CHLORIDE 0.9 % 0.9 % IV SOLP",21,519,0.0678254051228437,692,19620,0.0404624277456647,0.0352701325178389,1.14721507567911,498,18928,0.6090234048952
"704",806,"IP ICU SUR/TRAUMA  ADMIT",7652,"81421","ESMOLOL IN NACL (ISO-OSM) 2,500 MG/250 ML (10 MG/ML) IV SOLP",1,21,0.0027443805541035,72,1479,0.0476190476190476,0.0486815415821501,0.978174603174603,20,1407,0.999999999999947
"705",806,"IP ICU SUR/TRAUMA  ADMIT",7652,"82384","PANTOPRAZOLE 40 MG IV SOLR",20,621,0.0811552535284893,688,12925,0.0322061191626409,0.0532301740812379,0.605035014792345,601,12237,0.0273052553255269
"706",806,"IP ICU SUR/TRAUMA  ADMIT",7652,"88043","PANTOPRAZOLE 40 MG PO TBEC",5,22,0.00287506534239415,624,31884,0.227272727272727,0.0195709446744449,11.6127622377622,17,31260,4.42154302175863e-10
"707",806,"IP ICU SUR/TRAUMA  ADMIT",7652,"89065","LIDOCAINE 5 % TP PTMD",2,82,0.0107161526398327,197,10907,0.024390243902439,0.018061795177409,1.35037761545128,80,10710,0.990011300261359
"708",806,"IP ICU SUR/TRAUMA  ADMIT",7652,"110872","HYDROMORPHONE 2 MG/ML INJ SYRG",9,263,0.0343700993204391,738,23934,0.0342205323193916,0.0308347956881424,1.10980246684596,254,23196,0.891437077866896
"709",806,"IP ICU SUR/TRAUMA  ADMIT",7652,"110892","ENOXAPARIN 40 MG/0.4 ML SC SYRG",8,71,0.00927861996863565,499,13896,0.112676056338028,0.0359096142774899,3.13776849473595,63,13397,0.00173890127062974
"710",806,"IP ICU SUR/TRAUMA  ADMIT",7652,"112586","HYDROMORPHONE 1 MG/ML INJ SYRG",9,261,0.0341087297438578,1219,33427,0.0344827586206897,0.036467526251234,0.945574382620011,252,32208,0.996293400039863
"711",806,"IP ICU SUR/TRAUMA  ADMIT",7652,"126992","LIDOCAINE (PF) 10 MG/ML (1 %) INJ SOLN",6,625,0.0816779926816519,457,11068,0.0096,0.0412902059992772,0.232500656455142,619,10611,0.000119485679129508
"712",806,"IP ICU SUR/TRAUMA  ADMIT",7652,"198509","ONDANSETRON HCL (PF) 4 MG/2 ML INJ SOLN",18,1280,0.167276529012023,705,36939,0.0140625,0.0190855193697718,0.736815159574468,1262,36234,0.233063242254762
"713",806,"IP ICU SUR/TRAUMA  ADMIT",7652,"200439","HYDROMORPHONE (PF) 2 MG/ML INJ SOLN",3,87,0.0113695765812859,142,3356,0.0344827586206897,0.0423122765196663,0.814958717824186,84,3214,0.929364322353941
"714",806,"IP ICU SUR/TRAUMA  ADMIT",7652,"202606","FAMOTIDINE (PF) 20 MG/2 ML IV SOLN",12,206,0.0269210663878725,288,4280,0.058252427184466,0.0672897196261682,0.865695792880259,194,3992,0.715552429650592
"715",806,"IP ICU SUR/TRAUMA  ADMIT",7652,"207694","NOREPINEPHRINE BITARTRATE-NACL 4 MG/250 ML (16 MCG/ML) IV SOLN",4,63,0.00823314166231051,56,1641,0.0634920634920635,0.0341255332114564,1.86054421768707,59,1585,0.371983940100794
"716",806,"IP ICU SUR/TRAUMA  ADMIT",7652,"210741","PHENYLEPHRINE IN 0.9% NACL(PF) 40 MG/250 ML (160 MCG/ML) IV SOLN",1,50,0.00653423941453215,43,1494,0.02,0.0287817938420348,0.694883720930233,49,1451,0.999999999999957
"717",806,"IP ICU SUR/TRAUMA  ADMIT",7652,"211084","CALCIUM GLUCONATE IN 0.9% NACL 1 GRAM/50 ML IV SOLN",14,1407,0.183873497124935,326,12268,0.00995024875621891,0.0265731985653733,0.374446784482496,1393,11942,0.000213484073701903
"718",806,"IP ICU SUR/TRAUMA  ADMIT",7652,"212629","ACETAMINOPHEN 1,000 MG/100 ML (10 MG/ML) IV SOLN",21,886,0.11578672242551,510,18335,0.0237020316027088,0.0278156531224434,0.852111273403267,865,17825,0.532155356877485
"719",806,"IP ICU SUR/TRAUMA  ADMIT",7652,"212945","HEPARIN, PORCINE (PF) 5,000 UNIT/0.5 ML INJ SOLN",8,193,0.0252221641400941,452,13480,0.0414507772020725,0.0335311572700297,1.23618689531845,185,13028,0.685594889966275
"720",806,"IP ICU SUR/TRAUMA  ADMIT",7652,"221562","CALCIUM CHLORIDE 1 GRAM (13.6 MEQ)/50 ML NS IVPB",19,193,0.0252221641400941,156,2315,0.0984455958549223,0.0673866090712743,1.46090740002657,174,2159,0.138842247760953
"721",806,"IP ICU SUR/TRAUMA  ADMIT",7652,"226058","EPINEPHRINE HCL IN 0.9 % NACL 4 MG/250 ML (16 MCG/ML) IV SOLN",2,18,0.00235232618923157,56,1218,0.111111111111111,0.0459770114942529,2.41666666666667,16,1162,0.46186486587034
"722",806,"IP ICU SUR/TRAUMA  ADMIT",7652,"229762","DEXMEDETOMIDINE IN 0.9 % NACL 400 MCG/100 ML (4 MCG/ML) IV SOLN",12,234,0.0305802404600105,291,6612,0.0512820512820513,0.044010889292196,1.16521279407877,222,6321,0.71155514998999
"723",806,"IP ICU SUR/TRAUMA  ADMIT",7652,"520046","VANCOMYCIN IVPB (CUSTOM DOSE)",1,12,0.00156821745948772,1808,23328,0.0833333333333333,0.0775034293552812,1.07522123893805,11,21520,0.999999999999919
"724",806,"IP ICU SUR/TRAUMA  ADMIT",7652,"520064","CEFAZOLIN 2 G IVPB",1,20,0.00261369576581286,109,2674,0.05,0.0407629020194465,1.22660550458716,19,2565,0.99999999999988
"725",806,"IP ICU SUR/TRAUMA  ADMIT",7652,"530003","FENTANYL  10 MCG/ML IV INFUSION",1,15,0.00196027182435964,51,585,0.0666666666666667,0.0871794871794872,0.764705882352941,14,534,0.999999999999966
"726",806,"IP ICU SUR/TRAUMA  ADMIT",7652,"530004","MIDAZOLAM 50 MG IN D5W 100 ML IV INFUSION",1,8,0.00104547830632514,65,1105,0.125,0.0588235294117647,2.125,7,1040,0.969313034010182
"727",806,"IP ICU SUR/TRAUMA  ADMIT",7652,"530006","EPINEPHRINE IV INFUSION",1,28,0.003659174072138,99,2540,0.0357142857142857,0.0389763779527559,0.916305916305916,27,2441,0.999999999999998
"728",806,"IP ICU SUR/TRAUMA  ADMIT",7652,"530008","NITROPRUSSIDE IV INFUSION",1,9,0.00117616309461579,79,2082,0.111111111111111,0.0379442843419789,2.92827004219409,8,2003,0.786320916896849
"729",806,"IP ICU SUR/TRAUMA  ADMIT",7652,"530011","NOREPINEPHRINE IV INFUSION",2,34,0.00444328280188186,92,2909,0.0588235294117647,0.0316259883121348,1.85997442455243,32,2817,0.684623638193078
"730",806,"IP ICU SUR/TRAUMA  ADMIT",7652,"530025","DEXMEDETOMIDINE IV INFUSION",29,71,0.00927861996863565,530,2902,0.408450704225352,0.18263266712612,2.23646027106032,42,2372,3.19988743234354e-06
"731",806,"IP ICU SUR/TRAUMA  ADMIT",7652,"530031","VASOPRESSIN 1 UNIT/ML IV INFUSION",4,48,0.00627286983795086,215,4489,0.0833333333333333,0.0478948540877701,1.73992248062015,44,4274,0.423168878710224
"732",806,"IP ICU SUR/TRAUMA  ADMIT",7652,"530120","HYDROMORPHONE 10 MG IN 100 ML IV INFUSION (SHC)",13,232,0.0303188708834292,130,2894,0.0560344827586207,0.0449205252246026,1.24741379310345,219,2764,0.53770326790398
"733",806,"IP ICU SUR/TRAUMA  ADMIT",7652,"540102","NS IV BOLUS",1,13,0.00169890224777836,2225,80957,0.0769230769230769,0.0274837259285794,2.79885911840968,12,78732,0.808846785615324
"734",806,"IP ICU SUR/TRAUMA  ADMIT",7652,"540106","FENTANYL (PF) 50 MCG/ML INJECTION",10,396,0.0517511761630946,461,18637,0.0252525252525253,0.0247357407308043,1.02089221937378,386,18176,0.999999999999999
"735",806,"IP ICU SUR/TRAUMA  ADMIT",7652,"540301","POTASSIUM CHLORIDE ORAL SCALE",4,156,0.0203868269733403,105,3653,0.0256410256410256,0.0287434984943882,0.892063492063492,152,3548,0.999999999999997
"736",806,"IP ICU SUR/TRAUMA  ADMIT",7652,"540302","POTASSIUM CHLORIDE IV SCALE",13,1485,0.194066910611605,150,4660,0.00875420875420875,0.0321888412017167,0.271964085297419,1472,4510,1.57706245781378e-06
"737",806,"IP ICU SUR/TRAUMA  ADMIT",7652,"540304","MAGNESIUM SULFATE IV SCALE ",12,1504,0.196549921589127,78,4104,0.00797872340425532,0.0190058479532164,0.419803600654664,1492,4026,0.00524917240290593
"738",806,"IP ICU SUR/TRAUMA  ADMIT",7652,"540965","PIPERACILLIN-TAZOBACTAM 3.375 GRAM/50 ML MINI-BAG PLUS",4,29,0.00378985886042865,235,4195,0.137931034482759,0.0560190703218117,2.46221570066031,25,3960,0.13376814737282
"739",806,"IP ICU SUR/TRAUMA  ADMIT",7652,"541048","HYDROMORPHONE VARIABLE DOSE INJECTION",1,33,0.00431259801359122,104,5739,0.0303030303030303,0.0181216239763025,1.6722027972028,32,5635,0.999999999999626
"740",806,"IP ICU SUR/TRAUMA  ADMIT",7652,"541061","VANCOMYCIN PER PHARMACY PROTOCOL",2,15,0.00196027182435964,239,5475,0.133333333333333,0.0436529680365297,3.05439330543933,13,5236,0.288214446244473
"741",806,"IP ICU SUR/TRAUMA  ADMIT",7652,"541085","CEFTRIAXONE 1 GRAM/50 ML MINI-BAG PLUS",4,17,0.00222164140094093,411,7130,0.235294117647059,0.0576437587657784,4.0818663231716,13,6719,0.00907805814411235
"742",811,"IP PAMF ENT POSTOP",29,"110892","ENOXAPARIN 40 MG/0.4 ML SC SYRG",1,1,0.0344827586206897,499,13896,1,0.0359096142774899,27.8476953907816,0,13397,0.0127154320473097
"743",812,"IP ENT GENERAL ADMISSION",838,"5002","METOCLOPRAMIDE HCL 5 MG/ML INJ SOLN",1,113,0.134844868735084,346,10128,0.00884955752212389,0.0341627172195893,0.259041383190956,112,9782,0.22338234210862
"744",812,"IP ENT GENERAL ADMISSION",838,"14863","POTASSIUM CHLORID-D5-0.45%NACL 20 MEQ/L IV SOLP",5,191,0.227923627684964,314,8762,0.0261780104712042,0.035836566993837,0.730483209390736,186,8448,0.606487539711785
"745",812,"IP ENT GENERAL ADMISSION",838,"15861","D5 %-0.45 % SODIUM CHLORIDE IV SOLP",1,9,0.0107398568019093,158,4300,0.111111111111111,0.0367441860465116,3.0239099859353,8,4142,0.766313882271774
"746",812,"IP ENT GENERAL ADMISSION",838,"22473","KETOROLAC 30 MG/ML (1 ML) INJ SOLN",1,10,0.0119331742243437,132,2852,0.1,0.0462833099579243,2.16060606060606,9,2720,0.957646452386939
"747",812,"IP ENT GENERAL ADMISSION",838,"25365","CEFAZOLIN IN DEXTROSE (ISO-OS) 1 GRAM/50 ML IV PGBK",3,71,0.0847255369928401,258,5335,0.0422535211267606,0.0483598875351453,0.87373075663282,68,5077,0.999999999999915
"748",812,"IP ENT GENERAL ADMISSION",838,"27838","SODIUM CHLORIDE 0.9 % 0.9 % IV SOLP",1,19,0.022673031026253,692,19620,0.0526315789473684,0.0352701325178389,1.49224216610891,18,18928,0.999999999999997
"749",812,"IP ENT GENERAL ADMISSION",838,"110892","ENOXAPARIN 40 MG/0.4 ML SC SYRG",2,38,0.045346062052506,499,13896,0.0526315789473684,0.0359096142774899,1.46566817846219,36,13397,0.907132317225053
"750",812,"IP ENT GENERAL ADMISSION",838,"117862","HYDROCODONE-ACETAMINOPHEN 7.5-325 MG/15 ML PO SOLN",2,101,0.120525059665871,79,3308,0.0198019801980198,0.0238814993954051,0.82917658854493,99,3229,0.999999999999999
"751",812,"IP ENT GENERAL ADMISSION",838,"198509","ONDANSETRON HCL (PF) 4 MG/2 ML INJ SOLN",3,277,0.33054892601432,705,36939,0.0108303249097473,0.0190855193697718,0.56746293878178,274,36234,0.434651831255433
"752",812,"IP ENT GENERAL ADMISSION",838,"209037","ACETAMINOPHEN 650 MG/20.3 ML PO SOLN",1,52,0.0620525059665871,192,8611,0.0192307692307692,0.0222970618975729,0.862479967948718,51,8419,0.999999999999797
"753",812,"IP ENT GENERAL ADMISSION",838,"212945","HEPARIN, PORCINE (PF) 5,000 UNIT/0.5 ML INJ SOLN",1,122,0.145584725536993,452,13480,0.00819672131147541,0.0335311572700297,0.244450892209488,121,13028,0.193906294425452
"754",813,"IP ENT GENERAL POSTOP",568,"2332","DEXAMETHASONE SODIUM PHOSPHATE 4 MG/ML INJ SOLN",1,25,0.0440140845070423,390,6737,0.04,0.0578892682202761,0.690974358974359,24,6347,0.999999999999999
"755",813,"IP ENT GENERAL POSTOP",568,"2566","DOCUSATE SODIUM 100 MG PO CAPS",1,7,0.0123239436619718,542,37509,0.142857142857143,0.0144498653656456,9.8863995782815,6,36967,0.207017404340548
"756",813,"IP ENT GENERAL POSTOP",568,"4996","METHYLPREDNISOLONE ACETATE 80 MG/ML INJ SUSP",5,26,0.0457746478873239,7,34,0.192307692307692,0.205882352941176,0.934065934065934,21,27,1
"757",813,"IP ENT GENERAL POSTOP",568,"14863","POTASSIUM CHLORID-D5-0.45%NACL 20 MEQ/L IV SOLP",1,105,0.184859154929577,314,8762,0.00952380952380952,0.035836566993837,0.265756748559296,104,8448,0.236891494773988
"758",813,"IP ENT GENERAL POSTOP",568,"110892","ENOXAPARIN 40 MG/0.4 ML SC SYRG",3,46,0.0809859154929577,499,13896,0.0652173913043478,0.0359096142774899,1.81615404722488,43,13397,0.503614165131861
"759",813,"IP ENT GENERAL POSTOP",568,"198509","ONDANSETRON HCL (PF) 4 MG/2 ML INJ SOLN",1,213,0.375,705,36939,0.00469483568075117,0.0190855193697718,0.245989411647188,212,36234,0.199776337594964
"760",813,"IP ENT GENERAL POSTOP",568,"202606","FAMOTIDINE (PF) 20 MG/2 ML IV SOLN",2,38,0.0669014084507042,288,4280,0.0526315789473684,0.0672897196261682,0.782163742690058,36,3992,0.972940285668882
"761",813,"IP ENT GENERAL POSTOP",568,"209509","METHYLPREDNISOLONE SOD SUC(PF) 125 MG/2 ML INJ SOLR",4,25,0.0440140845070423,275,8000,0.16,0.034375,4.65454545454545,21,7725,0.00401758229732467
"762",813,"IP ENT GENERAL POSTOP",568,"212945","HEPARIN, PORCINE (PF) 5,000 UNIT/0.5 ML INJ SOLN",1,20,0.0352112676056338,452,13480,0.05,0.0335311572700297,1.49115044247788,19,13028,0.999999999999998
"763",813,"IP ENT GENERAL POSTOP",568,"540300","MORPHINE INJECTABLE SYRINGE",1,118,0.207746478873239,61,1002,0.00847457627118644,0.0608782435129741,0.139205334815226,117,941,0.0322145271620259
"764",814,"IP ENT HEAD AND NECK POSTOP",3366,"101","ACETAMINOPHEN 325 MG PO TABS",2,293,0.0870469399881165,981,42092,0.0068259385665529,0.0233060914187969,0.292882167322472,291,41111,0.0943308363978631
"765",814,"IP ENT HEAD AND NECK POSTOP",3366,"2566","DOCUSATE SODIUM 100 MG PO CAPS",2,405,0.120320855614973,542,37509,0.00493827160493827,0.0144498653656456,0.341752084187509,403,36967,0.164243641396504
"766",814,"IP ENT HEAD AND NECK POSTOP",3366,"2569","DOCUSATE SODIUM 50 MG/5 ML PO LIQD",6,270,0.0802139037433155,170,7328,0.0222222222222222,0.0231986899563319,0.957908496732026,264,7158,0.999999999999996
"767",814,"IP ENT HEAD AND NECK POSTOP",3366,"5002","METOCLOPRAMIDE HCL 5 MG/ML INJ SOLN",5,586,0.174093879976233,346,10128,0.00853242320819113,0.0341627172195893,0.24975833020971,581,9782,0.0010775992471599
"768",814,"IP ENT HEAD AND NECK POSTOP",3366,"5172","MORPHINE 4 MG/ML INJ SYRG",2,14,0.0041592394533571,238,5949,0.142857142857143,0.0400067238191293,3.57082833133253,12,5711,0.202306104824998
"769",814,"IP ENT HEAD AND NECK POSTOP",3366,"9626","CLINDAMYCIN IN 5 % DEXTROSE 600 MG/50 ML IV PGBK",4,121,0.0359477124183007,70,1432,0.0330578512396694,0.0488826815642458,0.676269185360095,117,1362,0.573800009466831
"770",814,"IP ENT HEAD AND NECK POSTOP",3366,"10813","OXYCODONE 5 MG/5 ML PO SOLN",3,221,0.0656565656565657,328,8370,0.0135746606334842,0.0391875746714456,0.346402163116654,218,8042,0.075788934790251
"771",814,"IP ENT HEAD AND NECK POSTOP",3366,"14863","POTASSIUM CHLORID-D5-0.45%NACL 20 MEQ/L IV SOLP",9,953,0.283125371360665,314,8762,0.00944386149003148,0.035836566993837,0.263525841960687,944,8448,2.43448110165578e-05
"772",814,"IP ENT HEAD AND NECK POSTOP",3366,"25365","CEFAZOLIN IN DEXTROSE (ISO-OS) 1 GRAM/50 ML IV PGBK",7,445,0.132204396910279,258,5335,0.0157303370786517,0.0483598875351453,0.325276543855065,438,5077,0.00233620426151259
"773",814,"IP ENT HEAD AND NECK POSTOP",3366,"27838","SODIUM CHLORIDE 0.9 % 0.9 % IV SOLP",1,58,0.0172311348781937,692,19620,0.0172413793103448,0.0352701325178389,0.488837950966713,57,18928,0.698694626515309
"774",814,"IP ENT HEAD AND NECK POSTOP",3366,"82384","PANTOPRAZOLE 40 MG IV SOLR",6,167,0.0496137849079026,688,12925,0.0359281437125748,0.0532301740812379,0.674958223088706,161,12237,0.413495545294657
"775",814,"IP ENT HEAD AND NECK POSTOP",3366,"88043","PANTOPRAZOLE 40 MG PO TBEC",1,33,0.00980392156862745,624,31884,0.0303030303030303,0.0195709446744449,1.5483682983683,32,31260,0.999999999999993
"776",814,"IP ENT HEAD AND NECK POSTOP",3366,"96559","PIPERACILLIN-TAZOBACTAM-DEXTRS 3.375 GRAM/50 ML IV PGBK",1,5,0.00148544266191325,1067,10067,0.2,0.105989867885169,1.88697282099344,4,9000,0.999999999999995
"777",814,"IP ENT HEAD AND NECK POSTOP",3366,"110872","HYDROMORPHONE 2 MG/ML INJ SYRG",2,95,0.0282234105763518,738,23934,0.0210526315789474,0.0308347956881424,0.68275566966196,93,23196,0.800062794329204
"778",814,"IP ENT HEAD AND NECK POSTOP",3366,"110892","ENOXAPARIN 40 MG/0.4 ML SC SYRG",3,187,0.0555555555555556,499,13896,0.0160427807486631,0.0359096142774899,0.446754471509865,184,13397,0.208750457555335
"779",814,"IP ENT HEAD AND NECK POSTOP",3366,"112586","HYDROMORPHONE 1 MG/ML INJ SYRG",2,41,0.0121806298276887,1219,33427,0.0487804878048781,0.036467526251234,1.33764180956002,39,32208,0.997198245733373
"780",814,"IP ENT HEAD AND NECK POSTOP",3366,"117862","HYDROCODONE-ACETAMINOPHEN 7.5-325 MG/15 ML PO SOLN",2,314,0.0932857991681521,79,3308,0.00636942675159236,0.0238814993954051,0.266709667016045,312,3229,0.0709243074459005
"781",814,"IP ENT HEAD AND NECK POSTOP",3366,"124216","VANCOMYCIN IN D5W 1 GRAM/200 ML IV PGBK",1,20,0.005941770647653,1951,16917,0.05,0.115327776792576,0.43354689902614,19,14966,0.572724609086698
"782",814,"IP ENT HEAD AND NECK POSTOP",3366,"198509","ONDANSETRON HCL (PF) 4 MG/2 ML INJ SOLN",16,1114,0.330956625074272,705,36939,0.0143626570915619,0.0190855193697718,0.752542113908094,1098,36234,0.304130057403062
"783",814,"IP ENT HEAD AND NECK POSTOP",3366,"202606","FAMOTIDINE (PF) 20 MG/2 ML IV SOLN",51,362,0.107546048722519,288,4280,0.140883977900552,0.0672897196261682,2.09369244935543,311,3992,4.14030083048459e-07
"784",814,"IP ENT HEAD AND NECK POSTOP",3366,"209037","ACETAMINOPHEN 650 MG/20.3 ML PO SOLN",7,247,0.0733808674985146,192,8611,0.0283400809716599,0.0222970618975729,1.27102311066127,240,8419,0.678769249218201
"785",814,"IP ENT HEAD AND NECK POSTOP",3366,"212945","HEPARIN, PORCINE (PF) 5,000 UNIT/0.5 ML INJ SOLN",5,481,0.142899584076055,452,13480,0.0103950103950104,0.0335311572700297,0.310010487001637,476,13028,0.00754743555964161
"786",814,"IP ENT HEAD AND NECK POSTOP",3366,"520002","DEXAMETHASONE (CUSTOM DOSE) IVPB",11,25,0.00742721330956625,168,1360,0.44,0.123529411764706,3.56190476190476,14,1192,1.22395765645211e-05
"787",814,"IP ENT HEAD AND NECK POSTOP",3366,"540300","MORPHINE INJECTABLE SYRINGE",4,780,0.231729055258467,61,1002,0.00512820512820513,0.0608782435129741,0.0842370744010088,776,941,1.05737027979507e-09
"788",814,"IP ENT HEAD AND NECK POSTOP",3366,"541048","HYDROMORPHONE VARIABLE DOSE INJECTION",1,46,0.0136660724896019,104,5739,0.0217391304347826,0.0181216239763025,1.1996237458194,45,5635,0.999999999999998
"789",814,"IP ENT HEAD AND NECK POSTOP",3366,"541085","CEFTRIAXONE 1 GRAM/50 ML MINI-BAG PLUS",1,7,0.00207961972667855,411,7130,0.142857142857143,0.0576437587657784,2.47827598192562,6,6719,0.876423662391561
"790",814,"IP ENT HEAD AND NECK POSTOP",3366,"541093","AMPICILLIN/SULBACTAM 1.5 GRAM/50 ML MINI-BAG PLUS",3,46,0.0136660724896019,29,343,0.0652173913043478,0.0845481049562682,0.77136431784108,43,314,0.8710450445486
"791",815,"IP ENT - HEAD AND NECK ADMISSION-PREOP",246,"5002","METOCLOPRAMIDE HCL 5 MG/ML INJ SOLN",1,37,0.150406504065041,346,10128,0.027027027027027,0.0341627172195893,0.791126386502109,36,9782,0.999999999999995
"792",815,"IP ENT - HEAD AND NECK ADMISSION-PREOP",246,"10813","OXYCODONE 5 MG/5 ML PO SOLN",1,35,0.142276422764228,328,8370,0.0285714285714286,0.0391875746714456,0.729094076655052,34,8042,0.999999999999812
"793",815,"IP ENT - HEAD AND NECK ADMISSION-PREOP",246,"14863","POTASSIUM CHLORID-D5-0.45%NACL 20 MEQ/L IV SOLP",1,46,0.186991869918699,314,8762,0.0217391304347826,0.035836566993837,0.606618665189698,45,8448,0.908044363650959
"794",815,"IP ENT - HEAD AND NECK ADMISSION-PREOP",246,"96559","PIPERACILLIN-TAZOBACTAM-DEXTRS 3.375 GRAM/50 ML IV PGBK",1,1,0.0040650406504065,1067,10067,1,0.105989867885169,9.4348641049672,0,9000,0.200796619232221
"795",815,"IP ENT - HEAD AND NECK ADMISSION-PREOP",246,"110892","ENOXAPARIN 40 MG/0.4 ML SC SYRG",1,9,0.0365853658536585,499,13896,0.111111111111111,0.0359096142774899,3.09418837675351,8,13397,0.752100320369339
"796",815,"IP ENT - HEAD AND NECK ADMISSION-PREOP",246,"198509","ONDANSETRON HCL (PF) 4 MG/2 ML INJ SOLN",1,49,0.199186991869919,705,36939,0.0204081632653061,0.0190855193697718,1.0693009118541,48,36234,0.999999999999991
"797",815,"IP ENT - HEAD AND NECK ADMISSION-PREOP",246,"212945","HEPARIN, PORCINE (PF) 5,000 UNIT/0.5 ML INJ SOLN",1,33,0.134146341463415,452,13480,0.0303030303030303,0.0335311572700297,0.903727540895683,32,13028,0.999999999999999
"798",815,"IP ENT - HEAD AND NECK ADMISSION-PREOP",246,"221636","PROCHLORPERAZINE EDISYLATE 10 MG/2 ML (5 MG/ML) INJ SOLN",2,30,0.121951219512195,177,6874,0.0666666666666667,0.0257491998836194,2.58907721280603,28,6697,0.405688675786015
"799",815,"IP ENT - HEAD AND NECK ADMISSION-PREOP",246,"520002","DEXAMETHASONE (CUSTOM DOSE) IVPB",8,28,0.113821138211382,168,1360,0.285714285714286,0.123529411764706,2.31292517006803,20,1192,0.0234457148758245
"800",815,"IP ENT - HEAD AND NECK ADMISSION-PREOP",246,"540300","MORPHINE INJECTABLE SYRINGE",2,35,0.142276422764228,61,1002,0.0571428571428571,0.0608782435129741,0.93864168618267,33,941,0.999999999999999
"801",816,"IP RAD NEURORADIOLOGY PRE-PROCEDURE",751,"16426","NS WITH POTASSIUM CHLORIDE 20 MEQ/L IV SOLP",1,8,0.0106524633821571,118,4415,0.125,0.026727066817667,4.67690677966102,7,4297,0.533427194484823
"802",816,"IP RAD NEURORADIOLOGY PRE-PROCEDURE",751,"27838","SODIUM CHLORIDE 0.9 % 0.9 % IV SOLP",4,352,0.468708388814913,692,19620,0.0113636363636364,0.0352701325178389,0.322188649500788,348,18928,0.02276242924129
"803",821,"IP RAD INTERVENTIONAL RADIOLOGY POSTOP (SAME DAY DISCHARGE)",2642,"101","ACETAMINOPHEN 325 MG PO TABS",2,25,0.00946252838758516,981,42092,0.08,0.0233060914187969,3.43257900101937,23,41111,0.224581279646696
"804",821,"IP RAD INTERVENTIONAL RADIOLOGY POSTOP (SAME DAY DISCHARGE)",2642,"4318","LACTATED RINGERS IV SOLP",1,2,0.000757002271006813,135,4847,0.5,0.0278522797606767,17.9518518518519,1,4712,0.0572346957934298
"805",821,"IP RAD INTERVENTIONAL RADIOLOGY POSTOP (SAME DAY DISCHARGE)",2642,"10814","OXYCODONE 5 MG PO TABS",3,63,0.0238455715367146,1478,56614,0.0476190476190476,0.0261066167379094,1.8240221663767,60,55136,0.499885808590635
"806",821,"IP RAD INTERVENTIONAL RADIOLOGY POSTOP (SAME DAY DISCHARGE)",2642,"27838","SODIUM CHLORIDE 0.9 % 0.9 % IV SOLP",1,18,0.00681302043906132,692,19620,0.0555555555555556,0.0352701325178389,1.57514450867052,17,18928,0.999999999999956
"807",821,"IP RAD INTERVENTIONAL RADIOLOGY POSTOP (SAME DAY DISCHARGE)",2642,"81505","CIPROFLOXACIN IN D5W 400 MG/200 ML IV PGBK",1,2,0.000757002271006813,242,3682,0.5,0.0657251493753395,7.60743801652893,1,3440,0.29424298677062
"808",821,"IP RAD INTERVENTIONAL RADIOLOGY POSTOP (SAME DAY DISCHARGE)",2642,"110872","HYDROMORPHONE 2 MG/ML INJ SYRG",2,27,0.010219530658592,738,23934,0.0740740740740741,0.0308347956881424,2.40228846732912,25,23196,0.458422233477916
"809",821,"IP RAD INTERVENTIONAL RADIOLOGY POSTOP (SAME DAY DISCHARGE)",2642,"112586","HYDROMORPHONE 1 MG/ML INJ SYRG",3,25,0.00946252838758516,1219,33427,0.12,0.036467526251234,3.29059885151764,22,32208,0.0906035340407528
"810",821,"IP RAD INTERVENTIONAL RADIOLOGY POSTOP (SAME DAY DISCHARGE)",2642,"124216","VANCOMYCIN IN D5W 1 GRAM/200 ML IV PGBK",1,2,0.000757002271006813,1951,16917,0.5,0.115327776792576,4.3354689902614,1,14966,0.551181481032122
"811",821,"IP RAD INTERVENTIONAL RADIOLOGY POSTOP (SAME DAY DISCHARGE)",2642,"198509","ONDANSETRON HCL (PF) 4 MG/2 ML INJ SOLN",2,130,0.0492051476154428,705,36939,0.0153846153846154,0.0190855193697718,0.806088379705401,128,36234,0.999999999998231
"812",821,"IP RAD INTERVENTIONAL RADIOLOGY POSTOP (SAME DAY DISCHARGE)",2642,"540300","MORPHINE INJECTABLE SYRINGE",1,62,0.0234670704012112,61,1002,0.0161290322580645,0.0608782435129741,0.264939185616076,61,941,0.237864383154073
"813",821,"IP RAD INTERVENTIONAL RADIOLOGY POSTOP (SAME DAY DISCHARGE)",2642,"541048","HYDROMORPHONE VARIABLE DOSE INJECTION",1,6,0.00227100681302044,104,5739,0.166666666666667,0.0181216239763025,9.19711538461539,5,5635,0.233935935882488
"814",823,"IP RAD ARTERIAL THROMBOLYSIS",13,"530040","ALTEPLASE INFUSION",1,5,0.384615384615385,22,207,0.2,0.106280193236715,1.88181818181818,4,185,0.999999999999999
"815",824,"IP RAD INTERVENTIONAL RADIOLOGY PRE-PROCEDURE",930,"1445","CEFAZOLIN 1 GRAM INJ SOLR",9,27,0.0290322580645161,47,571,0.333333333333333,0.0823117338003503,4.04964539007092,18,524,5.4164591812481e-05
"816",824,"IP RAD INTERVENTIONAL RADIOLOGY PRE-PROCEDURE",930,"4573","LORAZEPAM 1 MG PO TABS",1,53,0.056989247311828,337,8494,0.0188679245283019,0.0396750647515894,0.475561278763787,52,8157,0.673511833013784
"817",824,"IP RAD INTERVENTIONAL RADIOLOGY PRE-PROCEDURE",930,"27838","SODIUM CHLORIDE 0.9 % 0.9 % IV SOLP",16,449,0.482795698924731,692,19620,0.0356347438752784,0.0352701325178389,1.01033768039445,433,18928,0.999999999999778
"818",824,"IP RAD INTERVENTIONAL RADIOLOGY PRE-PROCEDURE",930,"81505","CIPROFLOXACIN IN D5W 400 MG/200 ML IV PGBK",2,44,0.0473118279569892,242,3682,0.0454545454545455,0.0657251493753395,0.691585274229902,42,3440,0.815142979018486
"819",824,"IP RAD INTERVENTIONAL RADIOLOGY PRE-PROCEDURE",930,"520187","ONDANSETRON (+DEXAMETHASONE) IVPB",2,28,0.0301075268817204,28,2757,0.0714285714285714,0.0101559666303954,7.03316326530612,26,2729,0.0274517956627377
"820",838,"RETIRED: IP SUR PANCREATECTOMY POSTOP",319,"198509","ONDANSETRON HCL (PF) 4 MG/2 ML INJ SOLN",1,95,0.297805642633229,705,36939,0.0105263157894737,0.0190855193697718,0.551534154535274,94,36234,0.815247584969921
"821",838,"RETIRED: IP SUR PANCREATECTOMY POSTOP",319,"541104","CEFOXITIN 1 GRAM/50 ML MINI-BAG PLUS",1,4,0.0125391849529781,9,214,0.25,0.0420560747663551,5.94444444444444,3,205,0.445165528196408
"822",848,"IP SUR BREAST PROCEDURES POSTOP",325,"5172","MORPHINE 4 MG/ML INJ SYRG",1,3,0.00923076923076923,238,5949,0.333333333333333,0.0400067238191293,8.33193277310924,2,5711,0.264235346629724
"823",848,"IP SUR BREAST PROCEDURES POSTOP",325,"110888","ENOXAPARIN 30 MG/0.3 ML SC SYRG",1,2,0.00615384615384615,73,1394,0.5,0.0523672883787661,9.54794520547945,1,1321,0.213386719932846
"824",848,"IP SUR BREAST PROCEDURES POSTOP",325,"202606","FAMOTIDINE (PF) 20 MG/2 ML IV SOLN",3,22,0.0676923076923077,288,4280,0.136363636363636,0.0672897196261682,2.02651515151515,19,3992,0.389112832378695
"825",851,"IP MED CELLULITIS",36,"124216","VANCOMYCIN IN D5W 1 GRAM/200 ML IV PGBK",2,10,0.277777777777778,1951,16917,0.2,0.115327776792576,1.73418759610456,8,14966,0.731747653063538
"826",853,"IP MED ALLERGIC REACTION",59,"101","ACETAMINOPHEN 325 MG PO TABS",1,10,0.169491525423729,981,42092,0.1,0.0233060914187969,4.29072375127421,9,41111,0.576182885786226
"827",853,"IP MED ALLERGIC REACTION",59,"2508","DIPHENHYDRAMINE HCL 50 MG/ML INJ SOLN",1,28,0.474576271186441,399,16019,0.0357142857142857,0.0249079218428117,1.43385248836377,27,15620,0.999999999999995
"828",853,"IP MED ALLERGIC REACTION",59,"213662","EPINEPHRINE 1 MG/ML (1:1,000) (1ML) INJ SOLN",2,36,0.610169491525424,69,5047,0.0555555555555556,0.0136714880126808,4.06360708534622,34,4978,0.155276031094858
"829",853,"IP MED ALLERGIC REACTION",59,"9000000","ZZZ IMS TEMPLATE",1,3,0.0508474576271186,1035,28824,0.333333333333333,0.0359075770191507,9.28309178743961,2,27789,0.223786333563954
"830",856,"IP MED DRUG OVERDOSE",38,"520118","ACETYLCYSTEINE IV INFUSION",1,63,1,44,493,0.0158730158730159,0.0892494929006085,0.177849927849928,62,449,0.0774754553305128
"831",857,"RETIRED IP MED ABDOMINAL PAIN",9,"110872","HYDROMORPHONE 2 MG/ML INJ SYRG",1,1,0.111111111111111,738,23934,1,0.0308347956881424,32.4308943089431,0,23196,0.00668630199023242
"832",857,"RETIRED IP MED ABDOMINAL PAIN",9,"110872","HYDROMORPHONE 2 MG/ML INJ SYRG",1,1,0.111111111111111,738,23934,1,0.0308347956881424,32.4308943089431,0,23196,0.00668630199023242
"833",859,"IP CAR GENERAL ADMIT",1453,"11664","WARFARIN 1 MG PO TABS",1,6,0.00412938747419133,98,3895,0.166666666666667,0.0251604621309371,6.62414965986394,5,3797,0.36634158623887
"834",859,"IP CAR GENERAL ADMIT",1453,"110892","ENOXAPARIN 40 MG/0.4 ML SC SYRG",2,59,0.0406056434962147,499,13896,0.0338983050847458,0.0359096142774899,0.943989674263782,57,13397,0.999999999999797
"835",859,"IP CAR GENERAL ADMIT",1453,"212945","HEPARIN, PORCINE (PF) 5,000 UNIT/0.5 ML INJ SOLN",8,217,0.149346180316586,452,13480,0.0368663594470046,0.0335311572700297,1.09946576403899,209,13028,0.935738085702399
"836",863,"IP CAR EPS/ABLATION (POST-PROCEDURE)",295,"15846","HEPARIN (PORCINE) IN 5 % DEX 25,000 UNIT/250 ML(100 UNIT/ML) IV SOLP",1,2,0.00677966101694915,68,899,0.5,0.0756395995550612,6.61029411764706,1,831,0.355863592746064
"837",864,"IP CAR ICD/PACEMAKER IMPLANT(PRE-PROCEDURE)",908,"25365","CEFAZOLIN IN DEXTROSE (ISO-OS) 1 GRAM/50 ML IV PGBK",2,319,0.351321585903084,258,5335,0.00626959247648903,0.0483598875351453,0.129644480085539,317,5077,0.000811533444844564
"838",864,"IP CAR ICD/PACEMAKER IMPLANT(PRE-PROCEDURE)",908,"124216","VANCOMYCIN IN D5W 1 GRAM/200 ML IV PGBK",2,58,0.0638766519823789,1951,16917,0.0344827586206897,0.115327776792576,0.298997861397338,56,14966,0.0854015840537023
"839",864,"IP CAR ICD/PACEMAKER IMPLANT(PRE-PROCEDURE)",908,"520064","CEFAZOLIN 2 G IVPB",1,51,0.0561674008810573,109,2674,0.0196078431372549,0.0407629020194465,0.481021766504767,50,2565,0.688217346209749
"840",865,"IP CAR ICD/PACEMAKER IMPLANT (POST-PROCEDURE)",1314,"9499","CEPHALEXIN 250 MG PO CAPS",2,18,0.0136986301369863,36,616,0.111111111111111,0.0584415584415584,1.90123456790123,16,580,0.671388840446334
"841",865,"IP CAR ICD/PACEMAKER IMPLANT (POST-PROCEDURE)",1314,"9500","CEPHALEXIN 500 MG PO CAPS",7,368,0.280060882800609,175,4220,0.0190217391304348,0.0414691943127962,0.458695652173913,361,4045,0.0480769481334383
"842",865,"IP CAR ICD/PACEMAKER IMPLANT (POST-PROCEDURE)",1314,"25365","CEFAZOLIN IN DEXTROSE (ISO-OS) 1 GRAM/50 ML IV PGBK",6,473,0.359969558599696,258,5335,0.0126849894291755,0.0483598875351453,0.262303948080043,467,5077,0.000550751485739096
"843",865,"IP CAR ICD/PACEMAKER IMPLANT (POST-PROCEDURE)",1314,"124216","VANCOMYCIN IN D5W 1 GRAM/200 ML IV PGBK",1,71,0.0540334855403349,1951,16917,0.0140845070422535,0.115327776792576,0.122125887049617,70,14966,0.0130284235065569
"844",867,"IP CAR EPS/ABLATION (PRE-PROCEDURE)",401,"25365","CEFAZOLIN IN DEXTROSE (ISO-OS) 1 GRAM/50 ML IV PGBK",1,79,0.197007481296758,258,5335,0.0126582278481013,0.0483598875351453,0.261750564223334,78,5077,0.22612501858523
"845",868,"IP PULM RH CATH POST",93,"101","ACETAMINOPHEN 325 MG PO TABS",1,4,0.043010752688172,981,42092,0.25,0.0233060914187969,10.7268093781855,3,41111,0.177904126837166
"846",870,"IP CAR ACUTE MI/STEMI ADMIT",76,"14113","ASPIRIN 81 MG PO TBEC",1,18,0.236842105263158,391,18448,0.0555555555555556,0.0211947094535993,2.62119920431941,17,18057,0.847061095470676
"847",870,"IP CAR ACUTE MI/STEMI ADMIT",76,"37637","METOPROLOL TARTRATE 50 MG PO TABS",1,11,0.144736842105263,809,19725,0.0909090909090909,0.0410139416983523,2.21654118440274,10,18916,0.941174673185643
"848",870,"IP CAR ACUTE MI/STEMI ADMIT",76,"212945","HEPARIN, PORCINE (PF) 5,000 UNIT/0.5 ML INJ SOLN",1,2,0.0263157894736842,452,13480,0.5,0.0335311572700297,14.9115044247788,1,13028,0.0894223689889605
"849",875,"IP CAR UNSTABLE ANGINA/NSTEMI ADMIT",335,"101","ACETAMINOPHEN 325 MG PO TABS",1,64,0.191044776119403,981,42092,0.015625,0.0233060914187969,0.670425586136595,63,41111,0.999999999999965
"850",875,"IP CAR UNSTABLE ANGINA/NSTEMI ADMIT",335,"680","ASPIRIN 81 MG PO CHEW",2,37,0.11044776119403,357,11203,0.0540540540540541,0.031866464339909,1.6962676962677,35,10846,0.765684219250243
"851",875,"IP CAR UNSTABLE ANGINA/NSTEMI ADMIT",335,"5604","NITROGLYCERIN 0.4 MG SL SUBL",2,101,0.301492537313433,77,2947,0.0198019801980198,0.0261282660332542,0.757875787578758,99,2870,0.940204918774548
"852",875,"IP CAR UNSTABLE ANGINA/NSTEMI ADMIT",335,"10176","HEPARIN (PORCINE) 1,000 UNIT/ML INJ SOLN",1,10,0.0298507462686567,164,2898,0.1,0.0565907522429262,1.76707317073171,9,2734,0.999999999999997
"853",875,"IP CAR UNSTABLE ANGINA/NSTEMI ADMIT",335,"10181","HEPARIN (PORCINE) 5,000 UNIT/ML INJ SOLN",2,11,0.0328358208955224,156,510,0.181818181818182,0.305882352941176,0.594405594405594,9,354,0.57946187630536
"854",875,"IP CAR UNSTABLE ANGINA/NSTEMI ADMIT",335,"15846","HEPARIN (PORCINE) IN 5 % DEX 25,000 UNIT/250 ML(100 UNIT/ML) IV SOLP",4,24,0.0716417910447761,68,899,0.166666666666667,0.0756395995550612,2.20343137254902,20,831,0.209316061518262
"855",875,"IP CAR UNSTABLE ANGINA/NSTEMI ADMIT",335,"79507","ATORVASTATIN 10 MG PO TABS",3,9,0.026865671641791,96,5116,0.333333333333333,0.0187646598905395,17.7638888888889,6,5020,1.71552159490559e-08
"856",875,"IP CAR UNSTABLE ANGINA/NSTEMI ADMIT",335,"83398","CLOPIDOGREL 75 MG PO TABS",1,13,0.0388059701492537,234,7279,0.0769230769230769,0.0321472729770573,2.39283366206443,12,7045,0.898626171043624
"857",875,"IP CAR UNSTABLE ANGINA/NSTEMI ADMIT",335,"212945","HEPARIN, PORCINE (PF) 5,000 UNIT/0.5 ML INJ SOLN",1,23,0.0686567164179104,452,13480,0.0434782608695652,0.0335311572700297,1.29665255867641,22,13028,0.999999999999998
"858",882,"RETIRED IP ORT HIP FRACTURE ADMIT",136,"5002","METOCLOPRAMIDE HCL 5 MG/ML INJ SOLN",1,19,0.139705882352941,346,10128,0.0526315789473684,0.0341627172195893,1.54061454213569,18,9782,0.999999999999976
"859",882,"RETIRED IP ORT HIP FRACTURE ADMIT",136,"5002","METOCLOPRAMIDE HCL 5 MG/ML INJ SOLN",1,19,0.139705882352941,346,10128,0.0526315789473684,0.0341627172195893,1.54061454213569,18,9782,0.999999999999976
"860",882,"RETIRED IP ORT HIP FRACTURE ADMIT",136,"10813","OXYCODONE 5 MG/5 ML PO SOLN",1,5,0.0367647058823529,328,8370,0.2,0.0391875746714456,5.10365853658537,4,8042,0.484511293371825
"861",882,"RETIRED IP ORT HIP FRACTURE ADMIT",136,"10813","OXYCODONE 5 MG/5 ML PO SOLN",1,5,0.0367647058823529,328,8370,0.2,0.0391875746714456,5.10365853658537,4,8042,0.484511293371825
"862",883,"IP ORT TUMOR POSTOP",160,"101","ACETAMINOPHEN 325 MG PO TABS",2,26,0.1625,981,42092,0.0769230769230769,0.0233060914187969,3.30055673174939,24,41111,0.245815928316414
"863",883,"IP ORT TUMOR POSTOP",160,"110892","ENOXAPARIN 40 MG/0.4 ML SC SYRG",1,9,0.05625,499,13896,0.111111111111111,0.0359096142774899,3.09418837675351,8,13397,0.752100320369339
"864",883,"IP ORT TUMOR POSTOP",160,"541048","HYDROMORPHONE VARIABLE DOSE INJECTION",1,21,0.13125,104,5739,0.0476190476190476,0.0181216239763025,2.62774725274725,20,5635,0.848131282070756
"865",884,"RETIRED IP ORT SPINAL FUSION POSTOP",1500,"102","ACETAMINOPHEN 500 MG PO TABS",1,129,0.086,392,15968,0.00775193798449612,0.0245490981963928,0.315772820756209,128,15576,0.344760866407146
"866",884,"RETIRED IP ORT SPINAL FUSION POSTOP",1500,"1080","BISACODYL 10 MG PR SUPP",2,485,0.323333333333333,344,22442,0.00412371134020619,0.0153284021031994,0.269024214816591,483,22098,0.0696405308147918
"867",884,"RETIRED IP ORT SPINAL FUSION POSTOP",1500,"2511","DIPHENHYDRAMINE HCL 12.5 MG/5 ML PO ELIX",1,24,0.016,57,714,0.0416666666666667,0.0798319327731092,0.521929824561403,23,657,0.765842641801687
"868",884,"RETIRED IP ORT SPINAL FUSION POSTOP",1500,"2566","DOCUSATE SODIUM 100 MG PO CAPS",1,265,0.176666666666667,542,37509,0.00377358490566038,0.0144498653656456,0.261150177539511,264,36967,0.231687800589354
"869",884,"RETIRED IP ORT SPINAL FUSION POSTOP",1500,"2567","DOCUSATE SODIUM 250 MG PO CAPS",3,217,0.144666666666667,296,17760,0.0138248847926267,0.0166666666666667,0.829493087557604,214,17464,0.953486410128214
"870",884,"RETIRED IP ORT SPINAL FUSION POSTOP",1500,"5002","METOCLOPRAMIDE HCL 5 MG/ML INJ SOLN",2,482,0.321333333333333,346,10128,0.004149377593361,0.0341627172195893,0.121459237761735,480,9782,0.000494615298894693
"871",884,"RETIRED IP ORT SPINAL FUSION POSTOP",1500,"5940","OXYCODONE-ACETAMINOPHEN 5-325 MG PO TABS",1,77,0.0513333333333333,218,7862,0.012987012987013,0.0277283134062579,0.468366495889432,76,7644,0.662579046521306
"872",884,"RETIRED IP ORT SPINAL FUSION POSTOP",1500,"10813","OXYCODONE 5 MG/5 ML PO SOLN",1,61,0.0406666666666667,328,8370,0.0163934426229508,0.0391875746714456,0.418332666933227,60,8042,0.559079894607559
"873",884,"RETIRED IP ORT SPINAL FUSION POSTOP",1500,"11349","SENNOSIDES 8.6 MG PO TABS",3,539,0.359333333333333,610,35793,0.00556586270871985,0.0170424384656218,0.326588399890508,536,35183,0.0594416447604967
"874",884,"RETIRED IP ORT SPINAL FUSION POSTOP",1500,"25365","CEFAZOLIN IN DEXTROSE (ISO-OS) 1 GRAM/50 ML IV PGBK",1,203,0.135333333333333,258,5335,0.00492610837438424,0.0483598875351453,0.101863520067209,202,5077,0.00678218845751698
"875",884,"RETIRED IP ORT SPINAL FUSION POSTOP",1500,"25424","POLYETHYLENE GLYCOL 3350 17 GRAM PO PWPK",5,505,0.336666666666667,712,36910,0.0099009900990099,0.0192901652668653,0.513266214261876,500,36198,0.172196093234049
"876",884,"RETIRED IP ORT SPINAL FUSION POSTOP",1500,"80840","ONDANSETRON HCL 8 MG PO TABS",1,3,0.002,170,10077,0.333333333333333,0.0168701002282425,19.7588235294118,2,9907,0.0446247092886682
"877",884,"RETIRED IP ORT SPINAL FUSION POSTOP",1500,"81141","ONDANSETRON HCL 4 MG PO TABS",2,199,0.132666666666667,87,4024,0.0100502512562814,0.0216202783300199,0.464853000635361,197,3937,0.391758355622167
"878",884,"RETIRED IP ORT SPINAL FUSION POSTOP",1500,"86533","MAGNESIUM HYDROXIDE 400 MG/5 ML PO SUSP",1,494,0.329333333333333,111,6618,0.00202429149797571,0.0167724388032638,0.120691541744173,493,6507,0.0186476698330876
"879",884,"RETIRED IP ORT SPINAL FUSION POSTOP",1500,"92173","ZOLPIDEM 5 MG PO TABS",1,60,0.04,159,8203,0.0166666666666667,0.019383152505181,0.859853249475891,59,8044,0.999999999999998
"880",884,"RETIRED IP ORT SPINAL FUSION POSTOP",1500,"110872","HYDROMORPHONE 2 MG/ML INJ SYRG",2,128,0.0853333333333333,738,23934,0.015625,0.0308347956881424,0.506732723577236,126,23196,0.460891619754251
"881",884,"RETIRED IP ORT SPINAL FUSION POSTOP",1500,"198509","ONDANSETRON HCL (PF) 4 MG/2 ML INJ SOLN",1,489,0.326,705,36939,0.00204498977505112,0.0190855193697718,0.10714876212853,488,36234,0.00975281518514197
"882",884,"RETIRED IP ORT SPINAL FUSION POSTOP",1500,"211084","CALCIUM GLUCONATE IN 0.9% NACL 1 GRAM/50 ML IV SOLN",1,97,0.0646666666666667,326,12268,0.0103092783505155,0.0265731985653733,0.387957750932895,96,11942,0.498584130765061
"883",884,"RETIRED IP ORT SPINAL FUSION POSTOP",1500,"221562","CALCIUM CHLORIDE 1 GRAM (13.6 MEQ)/50 ML NS IVPB",1,3,0.002,156,2315,0.333333333333333,0.0673866090712743,4.9465811965812,2,2159,0.494993206218388
"884",884,"RETIRED IP ORT SPINAL FUSION POSTOP",1500,"236263","CEFAZOLIN IN DEXTROSE (ISO-OS) 2 GRAM/100 ML IV PGBK",1,93,0.062,111,2584,0.010752688172043,0.0429566563467492,0.250314830959992,92,2473,0.207536331826898
"885",884,"RETIRED IP ORT SPINAL FUSION POSTOP",1500,"520064","CEFAZOLIN 2 G IVPB",1,67,0.0446666666666667,109,2674,0.0149253731343284,0.0407629020194465,0.366150896891688,66,2565,0.453737079851465
"886",884,"RETIRED IP ORT SPINAL FUSION POSTOP",1500,"540304","MAGNESIUM SULFATE IV SCALE ",1,269,0.179333333333333,78,4104,0.00371747211895911,0.0190058479532164,0.195596225336002,268,4026,0.112384753878924
"887",884,"RETIRED IP ORT SPINAL FUSION POSTOP",1500,"540598","THERAPEUTIC MULTIVITAMIN & MINERALS (GENERIC) PO TABS",1,69,0.046,17,1250,0.0144927536231884,0.0136,1.06564364876385,68,1233,0.999999999999926
"888",885,"IP ORT SPORTS ORTHO/REHAB POSTOP",27,"1080","BISACODYL 10 MG PR SUPP",1,9,0.333333333333333,344,22442,0.111111111111111,0.0153284021031994,7.24870801033592,8,22098,0.326910264620884
"889",885,"IP ORT SPORTS ORTHO/REHAB POSTOP",27,"2509","DIPHENHYDRAMINE HCL 25 MG PO CAPS",1,6,0.222222222222222,356,12049,0.166666666666667,0.0295460204166321,5.64091760299625,5,11693,0.437508676520942
"890",885,"IP ORT SPORTS ORTHO/REHAB POSTOP",27,"2566","DOCUSATE SODIUM 100 MG PO CAPS",1,4,0.148148148148148,542,37509,0.25,0.0144498653656456,17.3011992619926,3,36967,0.0641913323211949
"891",885,"IP ORT SPORTS ORTHO/REHAB POSTOP",27,"4711","MAGNESIUM CITRATE PO SOLN",1,9,0.333333333333333,131,5481,0.111111111111111,0.0239007480386791,4.64885496183206,8,5350,0.536812769990336
"892",885,"IP ORT SPORTS ORTHO/REHAB POSTOP",27,"5002","METOCLOPRAMIDE HCL 5 MG/ML INJ SOLN",1,9,0.333333333333333,346,10128,0.111111111111111,0.0341627172195893,3.252408477842,8,9782,0.724835763883227
"893",885,"IP ORT SPORTS ORTHO/REHAB POSTOP",27,"11349","SENNOSIDES 8.6 MG PO TABS",1,9,0.333333333333333,610,35793,0.111111111111111,0.0170424384656218,6.51967213114754,8,35183,0.37258689843434
"894",885,"IP ORT SPORTS ORTHO/REHAB POSTOP",27,"25424","POLYETHYLENE GLYCOL 3350 17 GRAM PO PWPK",1,9,0.333333333333333,712,36910,0.111111111111111,0.0192901652668653,5.75998751560549,8,36198,0.429436178459759
"895",885,"IP ORT SPORTS ORTHO/REHAB POSTOP",27,"81141","ONDANSETRON HCL 4 MG PO TABS",1,3,0.111111111111111,87,4024,0.333333333333333,0.0216202783300199,15.4176245210728,2,3937,0.0861160990834944
"896",885,"IP ORT SPORTS ORTHO/REHAB POSTOP",27,"86533","MAGNESIUM HYDROXIDE 400 MG/5 ML PO SUSP",1,9,0.333333333333333,111,6618,0.111111111111111,0.0167724388032638,6.62462462462462,8,6507,0.36797660845888
"897",885,"IP ORT SPORTS ORTHO/REHAB POSTOP",27,"90206","SODIUM PHOSPHATES 19-7 GRAM/118 ML PR ENEM",1,7,0.259259259259259,101,3581,0.142857142857143,0.02820441217537,5.06506364922206,6,3480,0.493200143304714
"898",885,"IP ORT SPORTS ORTHO/REHAB POSTOP",27,"110892","ENOXAPARIN 40 MG/0.4 ML SC SYRG",1,4,0.148148148148148,499,13896,0.25,0.0359096142774899,6.96192384769539,3,13397,0.338913857321974
"899",885,"IP ORT SPORTS ORTHO/REHAB POSTOP",27,"198509","ONDANSETRON HCL (PF) 4 MG/2 ML INJ SOLN",1,9,0.333333333333333,705,36939,0.111111111111111,0.0190855193697718,5.82174940898345,8,36234,0.424419424581305
"900",885,"IP ORT SPORTS ORTHO/REHAB POSTOP",27,"520064","CEFAZOLIN 2 G IVPB",1,3,0.111111111111111,109,2674,0.333333333333333,0.0407629020194465,8.17737003058104,2,2565,0.27292534734676
"901",886,"IP ORT TRAUMA",9299,"101","ACETAMINOPHEN 325 MG PO TABS",10,502,0.0539842993870309,981,42092,0.0199203187250996,0.0233060914187969,0.854725846867373,492,41111,0.725340161580053
"902",886,"IP ORT TRAUMA",9299,"102","ACETAMINOPHEN 500 MG PO TABS",25,1939,0.208517044843532,392,15968,0.0128932439401753,0.0245490981963928,0.525202344991633,1914,15576,0.00172452863744216
"903",886,"IP ORT TRAUMA",9299,"1080","BISACODYL 10 MG PR SUPP",13,2628,0.282611033444456,344,22442,0.00494672754946728,0.0153284021031994,0.322716452514955,2615,22098,3.14074442353618e-05
"904",886,"IP ORT TRAUMA",9299,"1801","CODEINE SULFATE 15 MG PO TABS",4,112,0.0120443058393376,8,181,0.0357142857142857,0.0441988950276243,0.808035714285714,108,173,0.957896299707526
"905",886,"IP ORT TRAUMA",9299,"2566","DOCUSATE SODIUM 100 MG PO CAPS",18,1883,0.202494891923863,542,37509,0.00955921402018056,0.0144498653656456,0.66154346620471,1865,36967,0.0990258132773922
"906",886,"IP ORT TRAUMA",9299,"2567","DOCUSATE SODIUM 250 MG PO CAPS",5,816,0.0877513711151737,296,17760,0.00612745098039216,0.0166666666666667,0.367647058823529,811,17464,0.0285432643507768
"907",886,"IP ORT TRAUMA",9299,"4318","LACTATED RINGERS IV SOLP",4,305,0.032799225723196,135,4847,0.0131147540983607,0.0278522797606767,0.470868245294475,301,4712,0.174269797711285
"908",886,"IP ORT TRAUMA",9299,"4711","MAGNESIUM CITRATE PO SOLN",12,2485,0.267233035810302,131,5481,0.00482897384305835,0.0239007480386791,0.202042791097731,2473,5350,4.96248186285625e-09
"909",886,"IP ORT TRAUMA",9299,"5002","METOCLOPRAMIDE HCL 5 MG/ML INJ SOLN",3,938,0.100871061404452,346,10128,0.00319829424307036,0.0341627172195893,0.0936194337971579,935,9782,3.5130856223318e-07
"910",886,"IP ORT TRAUMA",9299,"5373","NALOXONE 0.4 MG/ML INJ SOLN",19,2600,0.279599956984622,83,1774,0.00730769230769231,0.0467869222096956,0.156190917516219,2581,1691,4.74590469384353e-17
"911",886,"IP ORT TRAUMA",9299,"5940","OXYCODONE-ACETAMINOPHEN 5-325 MG PO TABS",1,21,0.00225830734487579,218,7862,0.0476190476190476,0.0277283134062579,1.71734381826125,20,7644,0.999999999999973
"912",886,"IP ORT TRAUMA",9299,"10181","HEPARIN (PORCINE) 5,000 UNIT/ML INJ SOLN",1,3,0.000322615334982256,156,510,0.333333333333333,0.305882352941176,1.08974358974359,2,354,1
"913",886,"IP ORT TRAUMA",9299,"10814","OXYCODONE 5 MG PO TABS",66,3130,0.336595332831487,1478,56614,0.0210862619808307,0.0261066167379094,0.807697994440289,3064,55136,0.095849408672613
"914",886,"IP ORT TRAUMA",9299,"11349","SENNOSIDES 8.6 MG PO TABS",32,2884,0.310140875362942,610,35793,0.0110957004160888,0.0170424384656218,0.651062959005025,2852,35183,0.0198671676254282
"915",886,"IP ORT TRAUMA",9299,"14632","TRAMADOL 50 MG PO TABS",4,191,0.0205398429938703,304,13808,0.0209424083769634,0.0220162224797219,0.951226233122072,187,13504,0.999999999999985
"916",886,"IP ORT TRAUMA",9299,"16830","MELATONIN 3 MG PO TABS",4,642,0.0690396816862028,456,17087,0.00623052959501558,0.0266869549950255,0.233467235065858,638,16631,0.00210948018811381
"917",886,"IP ORT TRAUMA",9299,"18307","GABAPENTIN 400 MG PO CAPS",3,17,0.00182815356489945,41,1580,0.176470588235294,0.0259493670886076,6.80057388809182,14,1539,0.00247434256542444
"918",886,"IP ORT TRAUMA",9299,"18308","GABAPENTIN 300 MG PO CAPS",7,386,0.041509839767717,588,19458,0.0181347150259067,0.0302189330866482,0.600111028867506,379,18870,0.219513601634146
"919",886,"IP ORT TRAUMA",9299,"18309","GABAPENTIN 100 MG PO CAPS",12,560,0.0602215291966878,199,6318,0.0214285714285714,0.0314973092750871,0.680330222541278,548,6119,0.231521251160569
"920",886,"IP ORT TRAUMA",9299,"25365","CEFAZOLIN IN DEXTROSE (ISO-OS) 1 GRAM/50 ML IV PGBK",23,1148,0.12345413485321,258,5335,0.0200348432055749,0.0483598875351453,0.414286389541636,1125,5077,2.72243346160393e-05
"921",886,"IP ORT TRAUMA",9299,"25424","POLYETHYLENE GLYCOL 3350 17 GRAM PO PWPK",17,2622,0.281965802774492,712,36910,0.0064836003051106,0.0192901652668653,0.336109111322517,2605,36198,3.57540889547944e-06
"922",886,"IP ORT TRAUMA",9299,"27838","SODIUM CHLORIDE 0.9 % 0.9 % IV SOLP",16,2213,0.237982578771911,692,19620,0.00723000451875282,0.0352701325178389,0.204989434476778,2197,18928,2.63359798228466e-12
"923",886,"IP ORT TRAUMA",9299,"34505","HYDROCODONE-ACETAMINOPHEN 5-325 MG PO TABS",2,61,0.00655984514463921,603,24164,0.0327868852459016,0.0249544777354743,1.31386781937308,59,23561,0.999999999999991
"924",886,"IP ORT TRAUMA",9299,"81141","ONDANSETRON HCL 4 MG PO TABS",12,1999,0.214969351543177,87,4024,0.00600300150075038,0.0216202783300199,0.277656069414017,1987,3937,1.18075919473151e-05
"925",886,"IP ORT TRAUMA",9299,"86533","MAGNESIUM HYDROXIDE 400 MG/5 ML PO SUSP",11,2598,0.279384880094634,111,6618,0.00423402617397998,0.0167724388032638,0.252439506481077,2587,6507,3.53162828186957e-06
"926",886,"IP ORT TRAUMA",9299,"90206","SODIUM PHOSPHATES 19-7 GRAM/118 ML PR ENEM",7,1696,0.182385202709969,101,3581,0.00412735849056604,0.02820441217537,0.146337334205119,1689,3480,1.47146356849465e-08
"927",886,"IP ORT TRAUMA",9299,"110872","HYDROMORPHONE 2 MG/ML INJ SYRG",17,1157,0.124421980858157,738,23934,0.0146931719965428,0.0308347956881424,0.476512708083001,1140,23196,0.0022820502549331
"928",886,"IP ORT TRAUMA",9299,"110888","ENOXAPARIN 30 MG/0.3 ML SC SYRG",1,36,0.00387138401978707,73,1394,0.0277777777777778,0.0523672883787661,0.530441400304414,35,1321,0.782109341983428
"929",886,"IP ORT TRAUMA",9299,"110892","ENOXAPARIN 40 MG/0.4 ML SC SYRG",13,656,0.07054521991612,499,13896,0.0198170731707317,0.0359096142774899,0.551859817195366,643,13397,0.0377421910626108
"930",886,"IP ORT TRAUMA",9299,"112586","HYDROMORPHONE 1 MG/ML INJ SYRG",16,763,0.0820518335304871,1219,33427,0.0209698558322412,0.036467526251234,0.57502819598386,747,32208,0.0299796825993686
"931",886,"IP ORT TRAUMA",9299,"124216","VANCOMYCIN IN D5W 1 GRAM/200 ML IV PGBK",4,62,0.00666738358963329,1951,16917,0.0645161290322581,0.115327776792576,0.559415353582117,58,14966,0.292868163410533
"932",886,"IP ORT TRAUMA",9299,"124873","SENNA LEAF EXTRACT 176 MG/5 ML PO SYRP",1,11,0.00118292289493494,90,4112,0.0909090909090909,0.0218871595330739,4.15353535353535,10,4022,0.597094506391832
"933",886,"IP ORT TRAUMA",9299,"198509","ONDANSETRON HCL (PF) 4 MG/2 ML INJ SOLN",19,2706,0.290999032153995,705,36939,0.00702143385070214,0.0190855193697718,0.367893255334874,2687,36234,8.59707240299176e-06
"934",886,"IP ORT TRAUMA",9299,"206114","ACIDOPHILUS-L.B-BB-S.THERMOPHL 1 BILLION-250 CELL-MG PO TABS",127,1437,0.154532745456501,70,2981,0.0883785664578984,0.0234820530023482,3.76366438015707,1310,2911,2.66302552330558e-22
"935",886,"IP ORT TRAUMA",9299,"212945","HEPARIN, PORCINE (PF) 5,000 UNIT/0.5 ML INJ SOLN",1,59,0.00634476825465104,452,13480,0.0169491525423729,0.0335311572700297,0.505474726263687,58,13028,0.730879114821355
"936",886,"IP ORT TRAUMA",9299,"214400","BENZOCAINE-MENTHOL 15-3.6 MG MM LOZG",3,1239,0.133240133347672,71,6103,0.00242130750605327,0.0116336228084549,0.20813013675272,1236,6032,0.00505031626060686
"937",886,"IP ORT TRAUMA",9299,"520064","CEFAZOLIN 2 G IVPB",3,240,0.0258092267985805,109,2674,0.0125,0.0407629020194465,0.306651376146789,237,2565,0.0448037694122282
"938",886,"IP ORT TRAUMA",9299,"540102","NS IV BOLUS",4,1601,0.172169050435531,2225,80957,0.00249843847595253,0.0274837259285794,0.0909061050326692,1597,78732,1.63863190920993e-09
"939",886,"IP ORT TRAUMA",9299,"540106","FENTANYL (PF) 50 MCG/ML INJECTION",1,63,0.00677492203462738,461,18637,0.0158730158730159,0.0247357407308043,0.641703680749234,62,18176,0.963381178407588
"940",886,"IP ORT TRAUMA",9299,"540301","POTASSIUM CHLORIDE ORAL SCALE",14,2400,0.258092267985805,105,3653,0.00583333333333333,0.0287434984943882,0.202944444444444,2386,3548,6.17481562429228e-10
"941",886,"IP ORT TRAUMA",9299,"540304","MAGNESIUM SULFATE IV SCALE ",13,2337,0.251317345951178,78,4104,0.00556268720581943,0.0190058479532164,0.292682926829268,2324,4026,1.82195336175567e-05
"942",886,"IP ORT TRAUMA",9299,"541048","HYDROMORPHONE VARIABLE DOSE INJECTION",3,308,0.0331218410581783,104,5739,0.00974025974025974,0.0181216239763025,0.537493756243756,305,5635,0.386990304819418
"943",886,"IP ORT TRAUMA",9299,"9000000","ZZZ IMS TEMPLATE",1,7,0.000752769114958598,1035,28824,0.142857142857143,0.0359075770191507,3.97846790890269,6,27789,0.613824700660452
"944",888,"RETIRED IP ORT REPLANT",51,"2566","DOCUSATE SODIUM 100 MG PO CAPS",1,10,0.196078431372549,542,37509,0.1,0.0144498653656456,6.92047970479705,9,36967,0.346791199110908
"945",891,"IP ORT TOTAL JOINT REPLACEMENT",17250,"101","ACETAMINOPHEN 325 MG PO TABS",15,1160,0.0672463768115942,981,42092,0.0129310344827586,0.0233060914187969,0.554834967837182,1145,41111,0.0260912165365678
"946",891,"IP ORT TOTAL JOINT REPLACEMENT",17250,"102","ACETAMINOPHEN 500 MG PO TABS",48,2877,0.166782608695652,392,15968,0.0166840458811262,0.0245490981963928,0.679619501606691,2829,15576,0.0122617060583818
"947",891,"IP ORT TOTAL JOINT REPLACEMENT",17250,"1080","BISACODYL 10 MG PR SUPP",20,4915,0.284927536231884,344,22442,0.00406917599186165,0.0153284021031994,0.265466417469067,4895,22098,6.78981822556026e-10
"948",891,"IP ORT TOTAL JOINT REPLACEMENT",17250,"1801","CODEINE SULFATE 15 MG PO TABS",4,130,0.00753623188405797,8,181,0.0307692307692308,0.0441988950276243,0.696153846153846,126,173,0.758045993439382
"949",891,"IP ORT TOTAL JOINT REPLACEMENT",17250,"2566","DOCUSATE SODIUM 100 MG PO CAPS",18,3753,0.217565217391304,542,37509,0.00479616306954436,0.0144498653656456,0.331917491836789,3735,36967,1.59199076818039e-06
"950",891,"IP ORT TOTAL JOINT REPLACEMENT",17250,"2567","DOCUSATE SODIUM 250 MG PO CAPS",3,1206,0.0699130434782609,296,17760,0.00248756218905473,0.0166666666666667,0.149253731343284,1203,17464,0.000210726226895637
"951",891,"IP ORT TOTAL JOINT REPLACEMENT",17250,"3760","HYDROMORPHONE 2 MG PO TABS",2,35,0.00202898550724638,241,5912,0.0571428571428571,0.0407645466847091,1.40177830468287,33,5671,0.952290278631641
"952",891,"IP ORT TOTAL JOINT REPLACEMENT",17250,"4318","LACTATED RINGERS IV SOLP",5,355,0.0205797101449275,135,4847,0.0140845070422535,0.0278522797606767,0.505685967657799,350,4712,0.16838341147435
"953",891,"IP ORT TOTAL JOINT REPLACEMENT",17250,"4711","MAGNESIUM CITRATE PO SOLN",11,4703,0.27263768115942,131,5481,0.00233893259621518,0.0239007480386791,0.0978602256477512,4692,5350,4.87962488772023e-20
"954",891,"IP ORT TOTAL JOINT REPLACEMENT",17250,"5002","METOCLOPRAMIDE HCL 5 MG/ML INJ SOLN",4,1177,0.068231884057971,346,10128,0.00339847068819031,0.0341627172195893,0.0994789339017095,1173,9782,1.35758656982961e-08
"955",891,"IP ORT TOTAL JOINT REPLACEMENT",17250,"5373","NALOXONE 0.4 MG/ML INJ SOLN",24,1493,0.0865507246376812,83,1774,0.0160750167448091,0.0467869222096956,0.343579273557727,1469,1691,1.47640026984859e-06
"956",891,"IP ORT TOTAL JOINT REPLACEMENT",17250,"6618","PROMETHAZINE 25 MG/ML INJ SOLN",3,304,0.0176231884057971,289,5149,0.00986842105263158,0.056127403379297,0.175821799307958,301,4860,0.000807214229634768
"957",891,"IP ORT TOTAL JOINT REPLACEMENT",17250,"8752","WARFARIN 7.5 MG PO TABS",1,6,0.000347826086956522,54,1901,0.166666666666667,0.0284061020515518,5.86728395061728,5,1847,0.424400813282763
"958",891,"IP ORT TOTAL JOINT REPLACEMENT",17250,"9626","CLINDAMYCIN IN 5 % DEXTROSE 600 MG/50 ML IV PGBK",1,113,0.00655072463768116,70,1432,0.00884955752212389,0.0488826815642458,0.181036662452592,112,1362,0.0848282514079184
"959",891,"IP ORT TOTAL JOINT REPLACEMENT",17250,"10813","OXYCODONE 5 MG/5 ML PO SOLN",4,43,0.00249275362318841,328,8370,0.0930232558139535,0.0391875746714456,2.37379466817924,39,8042,0.156789914211618
"960",891,"IP ORT TOTAL JOINT REPLACEMENT",17250,"10814","OXYCODONE 5 MG PO TABS",136,5314,0.308057971014493,1478,56614,0.0255927738050433,0.0261066167379094,0.980317521108742,5178,55136,0.857334574750836
"961",891,"IP ORT TOTAL JOINT REPLACEMENT",17250,"11349","SENNOSIDES 8.6 MG PO TABS",190,6712,0.389101449275362,610,35793,0.0283075089392133,0.0170424384656218,1.66100109419879,6522,35183,6.27997711796277e-10
"962",891,"IP ORT TOTAL JOINT REPLACEMENT",17250,"14632","TRAMADOL 50 MG PO TABS",8,458,0.0265507246376812,304,13808,0.0174672489082969,0.0220162224797219,0.793380831992645,450,13504,0.622384363548258
"963",891,"IP ORT TOTAL JOINT REPLACEMENT",17250,"16830","MELATONIN 3 MG PO TABS",6,880,0.0510144927536232,456,17087,0.00681818181818182,0.0266869549950255,0.255487440191388,874,16631,0.000427881038073498
"964",891,"IP ORT TOTAL JOINT REPLACEMENT",17250,"18308","GABAPENTIN 300 MG PO CAPS",8,614,0.0355942028985507,588,19458,0.0130293159609121,0.0302189330866482,0.431163996543243,606,18870,0.018774895553894
"965",891,"IP ORT TOTAL JOINT REPLACEMENT",17250,"18309","GABAPENTIN 100 MG PO CAPS",34,1088,0.0630724637681159,199,6318,0.03125,0.0314973092750871,0.99214824120603,1054,6119,0.999999999999966
"966",891,"IP ORT TOTAL JOINT REPLACEMENT",17250,"25365","CEFAZOLIN IN DEXTROSE (ISO-OS) 1 GRAM/50 ML IV PGBK",53,3569,0.206898550724638,258,5335,0.0148500980666853,0.0483598875351453,0.307074702270412,3516,5077,5.23476227949762e-17
"967",891,"IP ORT TOTAL JOINT REPLACEMENT",17250,"25424","POLYETHYLENE GLYCOL 3350 17 GRAM PO PWPK",11,4985,0.288985507246377,712,36910,0.00220661985957874,0.0192901652668653,0.114390925585746,4974,36198,5.84483845440267e-18
"968",891,"IP ORT TOTAL JOINT REPLACEMENT",17250,"27838","SODIUM CHLORIDE 0.9 % 0.9 % IV SOLP",14,4323,0.250608695652174,692,19620,0.00323849178811011,0.0352701325178389,0.0918196660154918,4309,18928,3.24564128618127e-29
"969",891,"IP ORT TOTAL JOINT REPLACEMENT",17250,"27920","OXYCODONE 10 MG PO TB12",5,307,0.0177971014492754,258,7208,0.0162866449511401,0.0357935627081021,0.455016034138828,302,6950,0.0963286865719873
"970",891,"IP ORT TOTAL JOINT REPLACEMENT",17250,"27921","OXYCODONE 20 MG PO TB12",2,67,0.00388405797101449,93,2927,0.0298507462686567,0.0317731465664503,0.939496068046862,65,2834,0.99999999999988
"971",891,"IP ORT TOTAL JOINT REPLACEMENT",17250,"27922","OXYCODONE 40 MG PO TB12",2,26,0.00150724637681159,47,1081,0.0769230769230769,0.0434782608695652,1.76923076923077,24,1034,0.736202868384599
"972",891,"IP ORT TOTAL JOINT REPLACEMENT",17250,"28899","OXYCODONE 15 MG PO TABS",2,21,0.00121739130434783,51,1050,0.0952380952380952,0.0485714285714286,1.96078431372549,19,999,0.639615082149031
"973",891,"IP ORT TOTAL JOINT REPLACEMENT",17250,"28900","OXYCODONE 30 MG PO TABS",1,17,0.000985507246376812,32,591,0.0588235294117647,0.0541455160744501,1.08639705882353,16,559,0.999999999999998
"974",891,"IP ORT TOTAL JOINT REPLACEMENT",17250,"34505","HYDROCODONE-ACETAMINOPHEN 5-325 MG PO TABS",3,31,0.00179710144927536,603,24164,0.0967741935483871,0.0249544777354743,3.87802920879474,28,23561,0.0474514071055678
"975",891,"IP ORT TOTAL JOINT REPLACEMENT",17250,"77052","CELECOXIB 200 MG PO CAPS",4,223,0.0129275362318841,20,1192,0.0179372197309417,0.0167785234899329,1.06905829596413,219,1172,0.999999999999998
"976",891,"IP ORT TOTAL JOINT REPLACEMENT",17250,"81141","ONDANSETRON HCL 4 MG PO TABS",12,4218,0.244521739130435,87,4024,0.00284495021337127,0.0216202783300199,0.131587122512712,4206,3937,1.16228018366552e-14
"977",891,"IP ORT TOTAL JOINT REPLACEMENT",17250,"86533","MAGNESIUM HYDROXIDE 400 MG/5 ML PO SUSP",14,4876,0.282666666666667,111,6618,0.00287120590648072,0.0167724388032638,0.171185952153959,4862,6507,2.36944257473611e-12
"978",891,"IP ORT TOTAL JOINT REPLACEMENT",17250,"90206","SODIUM PHOSPHATES 19-7 GRAM/118 ML PR ENEM",15,3566,0.206724637681159,101,3581,0.00420639371845205,0.02820441217537,0.149139563423532,3551,3480,2.12000390181469e-15
"979",891,"IP ORT TOTAL JOINT REPLACEMENT",17250,"92173","ZOLPIDEM 5 MG PO TABS",2,981,0.0568695652173913,159,8203,0.00203873598369011,0.019383152505181,0.105180825623962,979,8044,0.000154716513949341
"980",891,"IP ORT TOTAL JOINT REPLACEMENT",17250,"93715","CELECOXIB 100 MG PO CAPS",10,342,0.0198260869565217,42,1272,0.0292397660818713,0.0330188679245283,0.885547201336675,332,1230,0.858026544782622
"981",891,"IP ORT TOTAL JOINT REPLACEMENT",17250,"110872","HYDROMORPHONE 2 MG/ML INJ SYRG",7,806,0.0467246376811594,738,23934,0.0086848635235732,0.0308347956881424,0.281657891020598,799,23196,0.00044075732717436
"982",891,"IP ORT TOTAL JOINT REPLACEMENT",17250,"110892","ENOXAPARIN 40 MG/0.4 ML SC SYRG",29,1196,0.0693333333333333,499,13896,0.024247491638796,0.0359096142774899,0.675236761147713,1167,13397,0.0429474542972889
"983",891,"IP ORT TOTAL JOINT REPLACEMENT",17250,"112564","MORPHINE 2 MG/ML INJ SYRG",5,205,0.0118840579710145,276,6156,0.024390243902439,0.0448343079922027,0.544008483563097,200,5880,0.219217568849752
"984",891,"IP ORT TOTAL JOINT REPLACEMENT",17250,"124216","VANCOMYCIN IN D5W 1 GRAM/200 ML IV PGBK",11,261,0.0151304347826087,1951,16917,0.0421455938697318,0.115327776792576,0.365441830596747,250,14966,0.000329848848190787
"985",891,"IP ORT TOTAL JOINT REPLACEMENT",17250,"125758","PREGABALIN 75 MG PO CAPS",1,173,0.0100289855072464,31,1474,0.00578034682080925,0.0210312075983718,0.274846168189446,172,1443,0.278491194241998
"986",891,"IP ORT TOTAL JOINT REPLACEMENT",17250,"198509","ONDANSETRON HCL (PF) 4 MG/2 ML INJ SOLN",30,4958,0.287420289855072,705,36939,0.00605082694634933,0.0190855193697718,0.317037583788933,4928,36234,7.67620314430365e-11
"987",891,"IP ORT TOTAL JOINT REPLACEMENT",17250,"206114","ACIDOPHILUS-L.B-BB-S.THERMOPHL 1 BILLION-250 CELL-MG PO TABS",67,2481,0.143826086956522,70,2981,0.0270052398226522,0.0234820530023482,1.15003742730466,2414,2911,0.457986139611049
"988",891,"IP ORT TOTAL JOINT REPLACEMENT",17250,"212629","ACETAMINOPHEN 1,000 MG/100 ML (10 MG/ML) IV SOLN",4,103,0.00597101449275362,510,18335,0.0388349514563107,0.0278156531224434,1.39615457833619,99,17825,0.705929426847423
"989",891,"IP ORT TOTAL JOINT REPLACEMENT",17250,"214400","BENZOCAINE-MENTHOL 15-3.6 MG MM LOZG",2,1845,0.10695652173913,71,6103,0.0010840108401084,0.0116336228084549,0.0931791289743883,1843,6032,5.74141587525913e-05
"990",891,"IP ORT TOTAL JOINT REPLACEMENT",17250,"540102","NS IV BOLUS",3,2724,0.157913043478261,2225,80957,0.00110132158590308,0.0274837259285794,0.0400717715190813,2721,78732,6.68721155443136e-17
"991",891,"IP ORT TOTAL JOINT REPLACEMENT",17250,"540301","POTASSIUM CHLORIDE ORAL SCALE",28,4212,0.244173913043478,105,3653,0.00664767331433998,0.0287434984943882,0.231275720164609,4184,3548,6.77754623967285e-14
"992",891,"IP ORT TOTAL JOINT REPLACEMENT",17250,"540304","MAGNESIUM SULFATE IV SCALE ",26,4141,0.240057971014493,78,4104,0.00627867664815262,0.0190058479532164,0.330354986718184,4115,4026,3.79605974345796e-07
"993",891,"IP ORT TOTAL JOINT REPLACEMENT",17250,"541048","HYDROMORPHONE VARIABLE DOSE INJECTION",1,387,0.0224347826086957,104,5739,0.00258397932816537,0.0181216239763025,0.142590936195587,386,5635,0.0377950039908229
"994",891,"IP ORT TOTAL JOINT REPLACEMENT",17250,"9000000","ZZZ IMS TEMPLATE",5,50,0.00289855072463768,1035,28824,0.1,0.0359075770191507,2.78492753623188,45,27789,0.0403393769871987
"995",893,"IP ORT SHOULDER ELBOW ADMISSION POSTOP",1620,"102","ACETAMINOPHEN 500 MG PO TABS",5,272,0.167901234567901,392,15968,0.0183823529411765,0.0245490981963928,0.748799519807923,267,15576,0.649062005457801
"996",893,"IP ORT SHOULDER ELBOW ADMISSION POSTOP",1620,"1080","BISACODYL 10 MG PR SUPP",8,586,0.361728395061728,344,22442,0.0136518771331058,0.0153284021031994,0.890626240177792,578,22098,0.876015272088449
"997",893,"IP ORT SHOULDER ELBOW ADMISSION POSTOP",1620,"1801","CODEINE SULFATE 15 MG PO TABS",5,105,0.0648148148148148,8,181,0.0476190476190476,0.0441988950276243,1.07738095238095,100,173,0.999999999999996
"998",893,"IP ORT SHOULDER ELBOW ADMISSION POSTOP",1620,"1802","CODEINE SULFATE 30 MG PO TABS",1,2,0.00123456790123457,3,90,0.5,0.0333333333333333,15,1,87,0.147615778588567
"999",893,"IP ORT SHOULDER ELBOW ADMISSION POSTOP",1620,"2566","DOCUSATE SODIUM 100 MG PO CAPS",4,426,0.262962962962963,542,37509,0.00938967136150235,0.0144498653656456,0.649810300919911,422,36967,0.50451371213845
"1000",893,"IP ORT SHOULDER ELBOW ADMISSION POSTOP",1620,"2567","DOCUSATE SODIUM 250 MG PO CAPS",2,166,0.102469135802469,296,17760,0.0120481927710843,0.0166666666666667,0.72289156626506,164,17464,0.874217922048999
"1001",893,"IP ORT SHOULDER ELBOW ADMISSION POSTOP",1620,"4318","LACTATED RINGERS IV SOLP",2,135,0.0833333333333333,135,4847,0.0148148148148148,0.0278522797606767,0.531906721536351,133,4712,0.517705264860257
"1002",893,"IP ORT SHOULDER ELBOW ADMISSION POSTOP",1620,"4711","MAGNESIUM CITRATE PO SOLN",1,572,0.353086419753086,131,5481,0.00174825174825175,0.0239007480386791,0.0731463193295254,571,5350,0.000961956127089027
"1003",893,"IP ORT SHOULDER ELBOW ADMISSION POSTOP",1620,"5373","NALOXONE 0.4 MG/ML INJ SOLN",5,450,0.277777777777778,83,1774,0.0111111111111111,0.0467869222096956,0.237483266398929,445,1691,0.000862707743100295
"1004",893,"IP ORT SHOULDER ELBOW ADMISSION POSTOP",1620,"10814","OXYCODONE 5 MG PO TABS",19,334,0.206172839506173,1478,56614,0.0568862275449102,0.0261066167379094,2.17899654007276,315,55136,0.000855549113940065
"1005",893,"IP ORT SHOULDER ELBOW ADMISSION POSTOP",1620,"11349","SENNOSIDES 8.6 MG PO TABS",2,615,0.37962962962963,610,35793,0.0032520325203252,0.0170424384656218,0.190819672131148,613,35183,0.0131571309034887
"1006",893,"IP ORT SHOULDER ELBOW ADMISSION POSTOP",1620,"18308","GABAPENTIN 300 MG PO CAPS",7,135,0.0833333333333333,588,19458,0.0518518518518519,0.0302189330866482,1.71587301587302,128,18870,0.227019992658544
"1007",893,"IP ORT SHOULDER ELBOW ADMISSION POSTOP",1620,"18309","GABAPENTIN 100 MG PO CAPS",1,22,0.0135802469135802,199,6318,0.0454545454545455,0.0314973092750871,1.4431247144815,21,6119,0.999999999999986
"1008",893,"IP ORT SHOULDER ELBOW ADMISSION POSTOP",1620,"25365","CEFAZOLIN IN DEXTROSE (ISO-OS) 1 GRAM/50 ML IV PGBK",14,460,0.283950617283951,258,5335,0.0304347826086957,0.0483598875351453,0.629339400067408,446,5077,0.103273242343713
"1009",893,"IP ORT SHOULDER ELBOW ADMISSION POSTOP",1620,"25424","POLYETHYLENE GLYCOL 3350 17 GRAM PO PWPK",2,543,0.335185185185185,712,36910,0.00368324125230203,0.0192901652668653,0.190938812672005,541,36198,0.013063302228479
"1010",893,"IP ORT SHOULDER ELBOW ADMISSION POSTOP",1620,"27838","SODIUM CHLORIDE 0.9 % 0.9 % IV SOLP",2,425,0.262345679012346,692,19620,0.00470588235294118,0.0352701325178389,0.133424005440326,423,18928,0.00105396409812573
"1011",893,"IP ORT SHOULDER ELBOW ADMISSION POSTOP",1620,"27920","OXYCODONE 10 MG PO TB12",3,80,0.0493827160493827,258,7208,0.0375,0.0357935627081021,1.04767441860465,77,6950,0.999999999999834
"1012",893,"IP ORT SHOULDER ELBOW ADMISSION POSTOP",1620,"34505","HYDROCODONE-ACETAMINOPHEN 5-325 MG PO TABS",1,2,0.00123456790123457,603,24164,0.5,0.0249544777354743,20.0364842454395,1,23561,0.0415013714707364
"1013",893,"IP ORT SHOULDER ELBOW ADMISSION POSTOP",1620,"81141","ONDANSETRON HCL 4 MG PO TABS",4,545,0.33641975308642,87,4024,0.0073394495412844,0.0216202783300199,0.339470631656649,541,3937,0.0378905895758156
"1014",893,"IP ORT SHOULDER ELBOW ADMISSION POSTOP",1620,"86533","MAGNESIUM HYDROXIDE 400 MG/5 ML PO SUSP",2,583,0.359876543209877,111,6618,0.00343053173241852,0.0167724388032638,0.204533864911223,581,6507,0.0208269420877777
"1015",893,"IP ORT SHOULDER ELBOW ADMISSION POSTOP",1620,"90206","SODIUM PHOSPHATES 19-7 GRAM/118 ML PR ENEM",1,481,0.296913580246914,101,3581,0.00207900207900208,0.02820441217537,0.0737119449990737,480,3480,0.00102620712113615
"1016",893,"IP ORT SHOULDER ELBOW ADMISSION POSTOP",1620,"92173","ZOLPIDEM 5 MG PO TABS",1,73,0.0450617283950617,159,8203,0.0136986301369863,0.019383152505181,0.706728698199362,72,8044,0.999999999999963
"1017",893,"IP ORT SHOULDER ELBOW ADMISSION POSTOP",1620,"112564","MORPHINE 2 MG/ML INJ SYRG",6,192,0.118518518518519,276,6156,0.03125,0.0448343079922027,0.697010869565217,186,5880,0.470408048214631
"1018",893,"IP ORT SHOULDER ELBOW ADMISSION POSTOP",1620,"112586","HYDROMORPHONE 1 MG/ML INJ SYRG",1,57,0.0351851851851852,1219,33427,0.0175438596491228,0.036467526251234,0.481081703438251,56,32208,0.683200846020416
"1019",893,"IP ORT SHOULDER ELBOW ADMISSION POSTOP",1620,"124216","VANCOMYCIN IN D5W 1 GRAM/200 ML IV PGBK",1,30,0.0185185185185185,1951,16917,0.0333333333333333,0.115327776792576,0.289031266017427,29,14966,0.263000724082718
"1020",893,"IP ORT SHOULDER ELBOW ADMISSION POSTOP",1620,"198509","ONDANSETRON HCL (PF) 4 MG/2 ML INJ SOLN",4,563,0.347530864197531,705,36939,0.00710479573712256,0.0190855193697718,0.372261063451873,559,36234,0.0554062209147166
"1021",893,"IP ORT SHOULDER ELBOW ADMISSION POSTOP",1620,"206114","ACIDOPHILUS-L.B-BB-S.THERMOPHL 1 BILLION-250 CELL-MG PO TABS",4,157,0.0969135802469136,70,2981,0.0254777070063694,0.0234820530023482,1.08498635122839,153,2911,0.999999999999998
"1022",893,"IP ORT SHOULDER ELBOW ADMISSION POSTOP",1620,"233900","OXYCODONE 10 MG PO TR12",2,28,0.0172839506172839,38,949,0.0714285714285714,0.0400421496311907,1.78383458646617,26,911,0.732198360123568
"1023",893,"IP ORT SHOULDER ELBOW ADMISSION POSTOP",1620,"540102","NS IV BOLUS",2,338,0.208641975308642,2225,80957,0.00591715976331361,0.0274837259285794,0.215296855262283,336,78732,0.0240038769419564
"1024",893,"IP ORT SHOULDER ELBOW ADMISSION POSTOP",1620,"540301","POTASSIUM CHLORIDE ORAL SCALE",1,560,0.345679012345679,105,3653,0.00178571428571429,0.0287434984943882,0.062125850340136,559,3548,0.000264165480303086
"1025",893,"IP ORT SHOULDER ELBOW ADMISSION POSTOP",1620,"540304","MAGNESIUM SULFATE IV SCALE ",2,527,0.325308641975309,78,4104,0.00379506641366224,0.0190058479532164,0.199678878995767,525,4026,0.0190105151237844
"1026",894,"IP ICU COPD",91,"250","ALBUTEROL SULFATE 2.5 MG /3 ML (0.083 %) INH NEBU",1,3,0.032967032967033,106,3939,0.333333333333333,0.0269103833460269,12.3867924528302,2,3833,0.136831202158949
"1027",894,"IP ICU COPD",91,"12580","IPRATROPIUM BROMIDE 0.02 % INH SOLN",2,8,0.0879120879120879,127,3899,0.25,0.0325724544755065,7.6751968503937,6,3772,0.0143707656330183
"1028",894,"IP ICU COPD",91,"78668","IPRATROPIUM-ALBUTEROL 0.5 MG-3 MG(2.5 MG BASE)/3 ML INH NEBU",1,32,0.351648351648352,493,18456,0.03125,0.0267121803207629,1.16987829614604,31,17963,0.999999999999976
"1029",894,"IP ICU COPD",91,"115288","LEVOFLOXACIN IN D5W 750 MG/150 ML IV PGBK",1,10,0.10989010989011,208,3699,0.1,0.0562314138956475,1.77836538461538,9,3491,0.999999999999955
"1030",894,"IP ICU COPD",91,"520078","METHYLPREDNISOLONE IVPB",3,17,0.186813186813187,342,2212,0.176470588235294,0.154611211573237,1.14138286893705,14,1870,0.999999999999947
"1031",901,"IP ICU PNEUMONIA",124,"9487","CEFTRIAXONE 1 GRAM IV SOLR",2,5,0.0403225806451613,13,272,0.4,0.0477941176470588,8.36923076923077,3,259,0.0142352858346717
"1032",901,"IP ICU PNEUMONIA",124,"9488","CEFTRIAXONE 2 GRAM IV SOLR",1,1,0.00806451612903226,23,339,1,0.0678466076696165,14.7391304347826,0,316,0.0931576142406838
"1033",901,"IP ICU PNEUMONIA",124,"21063","AZITHROMYCIN 500 MG IV SOLR",4,7,0.0564516129032258,1,9,0.571428571428571,0.111111111111111,5.14285714285714,3,8,0.153576396549984
"1034",901,"IP ICU PNEUMONIA",124,"89444","PIPERACILLIN-TAZOBACTAM-DEXTRS 2.25 GRAM/50 ML IV PGBK",1,1,0.00806451612903226,63,534,1,0.117977528089888,8.47619047619048,0,471,0.240717581906376
"1035",901,"IP ICU PNEUMONIA",124,"96560","PIPERACILLIN-TAZOBACTAM-DEXTRS 4.5 GRAM/100 ML IV PGBK",1,8,0.0645161290322581,290,2601,0.125,0.111495578623606,1.12112068965517,7,2311,0.999999999999932
"1036",901,"IP ICU PNEUMONIA",124,"541271","PIPERACILLIN-TAZOBACTAM 3.375 GRAM/50 ML IVPB EXTENDED INFUSION",1,7,0.0564516129032258,466,8270,0.142857142857143,0.0563482466747279,2.53525444512569,6,7804,0.863315459000189
"1037",901,"IP ICU PNEUMONIA",124,"541273","PIPERACILLIN-TAZOBACTAM 4.5 GRAM/100 ML IVPB EXTENDED INFUSION",2,12,0.0967741935483871,148,1260,0.166666666666667,0.117460317460317,1.41891891891892,10,1112,0.939135008698663
"1038",902,"IP ICU SEPSIS MANAGEMENT",516,"101","ACETAMINOPHEN 325 MG PO TABS",1,3,0.00581395348837209,981,42092,0.333333333333333,0.0233060914187969,14.3024125042474,2,41111,0.100002477677862
"1039",902,"IP ICU SEPSIS MANAGEMENT",516,"96559","PIPERACILLIN-TAZOBACTAM-DEXTRS 3.375 GRAM/50 ML IV PGBK",3,20,0.0387596899224806,1067,10067,0.15,0.105989867885169,1.41522961574508,17,9000,0.783248409508895
"1040",902,"IP ICU SEPSIS MANAGEMENT",516,"115288","LEVOFLOXACIN IN D5W 750 MG/150 ML IV PGBK",1,13,0.0251937984496124,208,3699,0.0769230769230769,0.0562314138956475,1.36797337278107,12,3491,0.999999999999999
"1041",902,"IP ICU SEPSIS MANAGEMENT",516,"212945","HEPARIN, PORCINE (PF) 5,000 UNIT/0.5 ML INJ SOLN",1,9,0.0174418604651163,452,13480,0.111111111111111,0.0335311572700297,3.31366764995084,8,13028,0.714348887042159
"1042",902,"IP ICU SEPSIS MANAGEMENT",516,"520045","MEROPENEM CUSTOM IVPB",2,10,0.0193798449612403,100,1654,0.2,0.060459492140266,3.308,8,1554,0.240842756264353
"1043",902,"IP ICU SEPSIS MANAGEMENT",516,"520046","VANCOMYCIN IVPB (CUSTOM DOSE)",15,65,0.125968992248062,1808,23328,0.230769230769231,0.0775034293552812,2.97753573859769,50,21520,1.23351137875983e-05
"1044",902,"IP ICU SEPSIS MANAGEMENT",516,"530011","NOREPINEPHRINE IV INFUSION",3,31,0.060077519379845,92,2909,0.0967741935483871,0.0316259883121348,3.05995792426367,28,2817,0.126040709154815
"1045",902,"IP ICU SEPSIS MANAGEMENT",516,"530012","PHENYLEPHRINE IV INFUSION",1,5,0.00968992248062015,61,2180,0.2,0.0279816513761468,7.14754098360656,4,2119,0.334212411522971
"1046",902,"IP ICU SEPSIS MANAGEMENT",516,"540102","NS IV BOLUS",2,19,0.0368217054263566,2225,80957,0.105263157894737,0.0274837259285794,3.83001774098167,17,78732,0.170266250564635
"1047",902,"IP ICU SEPSIS MANAGEMENT",516,"540965","PIPERACILLIN-TAZOBACTAM 3.375 GRAM/50 ML MINI-BAG PLUS",1,25,0.0484496124031008,235,4195,0.04,0.0560190703218117,0.714042553191489,24,3960,0.999999999999906
"1048",902,"IP ICU SEPSIS MANAGEMENT",516,"541084","CEFEPIME 2 GRAM/100 ML MINI-BAG PLUS",1,2,0.00387596899224806,277,3459,0.5,0.0800809482509396,6.24368231046931,1,3182,0.377168029010213
"1049",902,"IP ICU SEPSIS MANAGEMENT",516,"541273","PIPERACILLIN-TAZOBACTAM 4.5 GRAM/100 ML IVPB EXTENDED INFUSION",1,4,0.00775193798449612,148,1260,0.25,0.117460317460317,2.12837837837838,3,1112,0.964719992261303
"1050",902,"IP ICU SEPSIS MANAGEMENT",516,"541544","CEFEPIME 2 G/100 ML EXTENDED INFUSION MINI-BAG PLUS",1,3,0.00581395348837209,60,934,0.333333333333333,0.0642398286937901,5.18888888888889,2,874,0.475098406599495
"1051",904,"IP ICU/CCU GENERAL ADMIT",22594,"101","ACETAMINOPHEN 325 MG PO TABS",30,1342,0.059396299902629,981,42092,0.022354694485842,0.0233060914187969,0.95917818582881,1312,41111,0.892139466038518
"1052",904,"IP ICU/CCU GENERAL ADMIT",22594,"102","ACETAMINOPHEN 500 MG PO TABS",1,71,0.0031424271930601,392,15968,0.0140845070422535,0.0245490981963928,0.573728082782409,70,15576,0.853694601189435
"1053",904,"IP ICU/CCU GENERAL ADMIT",22594,"1080","BISACODYL 10 MG PR SUPP",15,933,0.0412941488890856,344,22442,0.0160771704180064,0.0153284021031994,1.04884842593285,918,22098,0.963004088720522
"1054",904,"IP ICU/CCU GENERAL ADMIT",22594,"2566","DOCUSATE SODIUM 100 MG PO CAPS",10,679,0.0300522262547579,542,37509,0.0147275405007364,0.0144498653656456,1.01921645136923,669,36967,0.999999999999989
"1055",904,"IP ICU/CCU GENERAL ADMIT",22594,"2567","DOCUSATE SODIUM 250 MG PO CAPS",7,270,0.0119500752412145,296,17760,0.0259259259259259,0.0166666666666667,1.55555555555556,263,17464,0.349163424007352
"1056",904,"IP ICU/CCU GENERAL ADMIT",22594,"2569","DOCUSATE SODIUM 50 MG/5 ML PO LIQD",17,766,0.0339028060547048,170,7328,0.0221932114882507,0.0231986899563319,0.956657963446475,749,7158,0.960224761510593
"1057",904,"IP ICU/CCU GENERAL ADMIT",22594,"5002","METOCLOPRAMIDE HCL 5 MG/ML INJ SOLN",7,274,0.0121271133929362,346,10128,0.0255474452554745,0.0341627172195893,0.747816547824986,267,9782,0.543119607038416
"1058",904,"IP ICU/CCU GENERAL ADMIT",22594,"5018","METRONIDAZOLE IN NACL (ISO-OS) 500 MG/100 ML IV PGBK",1,10,0.00044259537930424,223,3847,0.1,0.0579672472056148,1.72511210762332,9,3624,0.999999999999997
"1059",904,"IP ICU/CCU GENERAL ADMIT",22594,"9516","CHLORHEXIDINE GLUCONATE 0.12 % MM MWSH",123,4335,0.191865096928388,89,4372,0.0283737024221453,0.0203568161024703,1.39381828078224,4212,4283,0.0184124744921784
"1060",904,"IP ICU/CCU GENERAL ADMIT",22594,"10011","FAMOTIDINE 20 MG PO TABS",10,86,0.00380632026201646,472,16960,0.116279069767442,0.0278301886792453,4.17816318486401,76,16488,4.03182877226094e-06
"1061",904,"IP ICU/CCU GENERAL ADMIT",22594,"10467","LORAZEPAM 2 MG/ML INJ SOLN",5,89,0.00393909887580774,749,20621,0.0561797752808989,0.0363221958197954,1.54670647004995,84,19872,0.474945550083053
"1062",904,"IP ICU/CCU GENERAL ADMIT",22594,"10607","MIDAZOLAM 1 MG/ML INJ SOLN",1,125,0.005532442241303,155,5616,0.008,0.0275997150997151,0.289858064516129,124,5461,0.291462071230317
"1063",904,"IP ICU/CCU GENERAL ADMIT",22594,"11150","PROPOFOL 10 MG/ML IV EMUL",10,218,0.00964857926883243,135,3592,0.0458715596330275,0.0375835189309577,1.22052327556915,208,3457,0.660866634540611
"1064",904,"IP ICU/CCU GENERAL ADMIT",22594,"11349","SENNOSIDES 8.6 MG PO TABS",19,1177,0.0520934761441091,610,35793,0.016142735768904,0.0170424384656218,0.947208100617017,1158,35183,0.904233972066567
"1065",904,"IP ICU/CCU GENERAL ADMIT",22594,"14863","POTASSIUM CHLORID-D5-0.45%NACL 20 MEQ/L IV SOLP",11,151,0.00668319022749402,314,8762,0.0728476821192053,0.035836566993837,2.03277512970852,140,8448,0.0287581125003283
"1066",904,"IP ICU/CCU GENERAL ADMIT",22594,"15861","D5 %-0.45 % SODIUM CHLORIDE IV SOLP",3,160,0.00708152606886784,158,4300,0.01875,0.0367441860465116,0.510284810126582,157,4142,0.325953803569839
"1067",904,"IP ICU/CCU GENERAL ADMIT",22594,"15980","DOBUTAMINE IN D5W 500 MG/250 ML (2,000 MCG/ML) IV SOLP",3,88,0.00389483933787731,33,665,0.0340909090909091,0.0496240601503759,0.68698347107438,85,632,0.706938606399145
"1068",904,"IP ICU/CCU GENERAL ADMIT",22594,"16426","NS WITH POTASSIUM CHLORIDE 20 MEQ/L IV SOLP",12,123,0.00544392316544215,118,4415,0.0975609756097561,0.026727066817667,3.65026870607689,111,4297,1.23601054326176e-05
"1069",904,"IP ICU/CCU GENERAL ADMIT",22594,"22472","KETOROLAC 15 MG/ML INJ SOLN",2,9,0.000398335841373816,215,5031,0.222222222222222,0.0427350427350427,5.2,7,4816,0.0674657403493547
"1070",904,"IP ICU/CCU GENERAL ADMIT",22594,"25424","POLYETHYLENE GLYCOL 3350 17 GRAM PO PWPK",12,904,0.0400106222891033,712,36910,0.0132743362831858,0.0192901652668653,0.688140101421895,892,36198,0.237530868640426
"1071",904,"IP ICU/CCU GENERAL ADMIT",22594,"27838","SODIUM CHLORIDE 0.9 % 0.9 % IV SOLP",16,362,0.0160219527308135,692,19620,0.0441988950276243,0.0352701325178389,1.25315364225721,346,18928,0.443016094802387
"1072",904,"IP ICU/CCU GENERAL ADMIT",22594,"81505","CIPROFLOXACIN IN D5W 400 MG/200 ML IV PGBK",1,6,0.000265557227582544,242,3682,0.166666666666667,0.0657251493753395,2.53581267217631,5,3440,0.863144842274486
"1073",904,"IP ICU/CCU GENERAL ADMIT",22594,"82384","PANTOPRAZOLE 40 MG IV SOLR",38,1026,0.045410285916615,688,12925,0.037037037037037,0.0532301740812379,0.695790267011197,988,12237,0.0296468338742933
"1074",904,"IP ICU/CCU GENERAL ADMIT",22594,"88043","PANTOPRAZOLE 40 MG PO TBEC",5,101,0.00447021333097282,624,31884,0.0495049504950495,0.0195709446744449,2.52951256664128,96,31260,0.0711799644532455
"1075",904,"IP ICU/CCU GENERAL ADMIT",22594,"94176","ONDANSETRON 4 MG PO TBDL",14,418,0.0185004868549172,153,4277,0.0334928229665072,0.0357727379003975,0.936266691684648,404,4124,0.918865137950959
"1076",904,"IP ICU/CCU GENERAL ADMIT",22594,"96559","PIPERACILLIN-TAZOBACTAM-DEXTRS 3.375 GRAM/50 ML IV PGBK",1,16,0.000708152606886784,1067,10067,0.0625,0.105989867885169,0.58967900656045,15,9000,0.874201348569363
"1077",904,"IP ICU/CCU GENERAL ADMIT",22594,"110872","HYDROMORPHONE 2 MG/ML INJ SYRG",8,311,0.0137647162963619,738,23934,0.0257234726688103,0.0308347956881424,0.834235223381173,303,23196,0.723815274593506
"1078",904,"IP ICU/CCU GENERAL ADMIT",22594,"110888","ENOXAPARIN 30 MG/0.3 ML SC SYRG",2,29,0.0012835265999823,73,1394,0.0689655172413793,0.0523672883787661,1.31695795937648,27,1321,0.999999999999995
"1079",904,"IP ICU/CCU GENERAL ADMIT",22594,"110892","ENOXAPARIN 40 MG/0.4 ML SC SYRG",21,285,0.0126139683101708,499,13896,0.0736842105263158,0.0359096142774899,2.05193544984706,264,13397,0.00137638297092591
"1080",904,"IP ICU/CCU GENERAL ADMIT",22594,"112586","HYDROMORPHONE 1 MG/ML INJ SYRG",12,350,0.0154908382756484,1219,33427,0.0342857142857143,0.036467526251234,0.940171100433611,338,32208,0.941549383532015
"1081",904,"IP ICU/CCU GENERAL ADMIT",22594,"115288","LEVOFLOXACIN IN D5W 750 MG/150 ML IV PGBK",3,62,0.00274409135168629,208,3699,0.0483870967741935,0.0562314138956475,0.860499379652605,59,3491,0.999999999999909
"1082",904,"IP ICU/CCU GENERAL ADMIT",22594,"115683","LANSOPRAZOLE 30 MG PO TBLD",1,11,0.000486854917234664,42,1961,0.0909090909090909,0.0214176440591535,4.24458874458874,10,1919,0.590189428502539
"1083",904,"IP ICU/CCU GENERAL ADMIT",22594,"124873","SENNA LEAF EXTRACT 176 MG/5 ML PO SYRP",6,479,0.0212003186686731,90,4112,0.0125260960334029,0.0218871595330739,0.572303409881698,473,4022,0.235465957713068
"1084",904,"IP ICU/CCU GENERAL ADMIT",22594,"198509","ONDANSETRON HCL (PF) 4 MG/2 ML INJ SOLN",65,3071,0.135921040984332,705,36939,0.0211657440573103,0.0190855193697718,1.10899492160707,3006,36234,0.46057737624689
"1085",904,"IP ICU/CCU GENERAL ADMIT",22594,"200439","HYDROMORPHONE (PF) 2 MG/ML INJ SOLN",8,143,0.00632911392405063,142,3356,0.0559440559440559,0.0423122765196663,1.32217078695952,135,3214,0.563691618395656
"1086",904,"IP ICU/CCU GENERAL ADMIT",22594,"202606","FAMOTIDINE (PF) 20 MG/2 ML IV SOLN",62,699,0.0309374170133664,288,4280,0.0886981402002861,0.0672897196261682,1.31815291686536,637,3992,0.0484987084568089
"1087",904,"IP ICU/CCU GENERAL ADMIT",22594,"205192","MILRINONE IN D5W 20 MG/100 ML IV PGBK",1,41,0.00181464105514738,27,851,0.024390243902439,0.0317273795534665,0.768744354110208,40,824,0.999999999999969
"1088",904,"IP ICU/CCU GENERAL ADMIT",22594,"206169","DOPAMINE IN 5 % DEXTROSE 400 MG/250 ML (1,600 MCG/ML) IV SOLN",8,80,0.00354076303443392,62,1778,0.1,0.0348706411698538,2.86774193548387,72,1716,0.00708801770275415
"1089",904,"IP ICU/CCU GENERAL ADMIT",22594,"207694","NOREPINEPHRINE BITARTRATE-NACL 4 MG/250 ML (16 MCG/ML) IV SOLN",9,176,0.00778967867575463,56,1641,0.0511363636363636,0.0341255332114564,1.49847808441558,167,1585,0.346591839697404
"1090",904,"IP ICU/CCU GENERAL ADMIT",22594,"209037","ACETAMINOPHEN 650 MG/20.3 ML PO SOLN",1,117,0.00517836593785961,192,8611,0.00854700854700855,0.0222970618975729,0.38332443019943,116,8419,0.491363755749711
"1091",904,"IP ICU/CCU GENERAL ADMIT",22594,"210741","PHENYLEPHRINE IN 0.9% NACL(PF) 40 MG/250 ML (160 MCG/ML) IV SOLN",2,60,0.00265557227582544,43,1494,0.0333333333333333,0.0287817938420348,1.15813953488372,58,1451,0.999999999999999
"1092",904,"IP ICU/CCU GENERAL ADMIT",22594,"212629","ACETAMINOPHEN 1,000 MG/100 ML (10 MG/ML) IV SOLN",28,1698,0.07515269540586,510,18335,0.016489988221437,0.0278156531224434,0.592831243215779,1670,17825,0.00728885880174614
"1093",904,"IP ICU/CCU GENERAL ADMIT",22594,"212945","HEPARIN, PORCINE (PF) 5,000 UNIT/0.5 ML INJ SOLN",63,1198,0.053022926440648,452,13480,0.0525876460767947,0.0335311572700297,1.56832183432565,1135,13028,0.000798238246509855
"1094",904,"IP ICU/CCU GENERAL ADMIT",22594,"226058","EPINEPHRINE HCL IN 0.9 % NACL 4 MG/250 ML (16 MCG/ML) IV SOLN",5,66,0.00292112950340798,56,1218,0.0757575757575758,0.0459770114942529,1.64772727272727,61,1162,0.417556541799695
"1095",904,"IP ICU/CCU GENERAL ADMIT",22594,"229762","DEXMEDETOMIDINE IN 0.9 % NACL 400 MCG/100 ML (4 MCG/ML) IV SOLN",26,489,0.0216429140479773,291,6612,0.0531697341513292,0.044010889292196,1.20810406257247,463,6321,0.404912418495319
"1096",904,"IP ICU/CCU GENERAL ADMIT",22594,"236263","CEFAZOLIN IN DEXTROSE (ISO-OS) 2 GRAM/100 ML IV PGBK",1,7,0.000309816765512968,111,2584,0.142857142857143,0.0429566563467492,3.32561132561133,6,2473,0.713322158583556
"1097",904,"IP ICU/CCU GENERAL ADMIT",22594,"520039","AZITHROMYCIN IVPB",1,25,0.0011064884482606,127,2522,0.04,0.0503568596352102,0.794330708661417,24,2395,0.999999999999895
"1098",904,"IP ICU/CCU GENERAL ADMIT",22594,"520046","VANCOMYCIN IVPB (CUSTOM DOSE)",43,270,0.0119500752412145,1808,23328,0.159259259259259,0.0775034293552812,2.05486725663717,227,21520,1.20944806737125e-06
"1099",904,"IP ICU/CCU GENERAL ADMIT",22594,"530004","MIDAZOLAM 50 MG IN D5W 100 ML IV INFUSION",4,51,0.00225723643445162,65,1105,0.0784313725490196,0.0588235294117647,1.33333333333333,47,1040,0.782852982237912
"1100",904,"IP ICU/CCU GENERAL ADMIT",22594,"530006","EPINEPHRINE IV INFUSION",11,107,0.00473577055855537,99,2540,0.102803738317757,0.0389763779527559,2.63759086188993,96,2441,0.00275861247789234
"1101",904,"IP ICU/CCU GENERAL ADMIT",22594,"530011","NOREPINEPHRINE IV INFUSION",7,244,0.0107993272550235,92,2909,0.0286885245901639,0.0316259883121348,0.907118674269423,237,2817,0.950852751804297
"1102",904,"IP ICU/CCU GENERAL ADMIT",22594,"530012","PHENYLEPHRINE IV INFUSION",7,101,0.00447021333097282,61,2180,0.0693069306930693,0.0279816513761468,2.47687063788346,94,2119,0.0367851411726822
"1103",904,"IP ICU/CCU GENERAL ADMIT",22594,"530025","DEXMEDETOMIDINE IV INFUSION",54,148,0.00655041161370275,530,2902,0.364864864864865,0.18263266712612,1.99780724120347,94,2372,7.08606523644049e-08
"1104",904,"IP ICU/CCU GENERAL ADMIT",22594,"530031","VASOPRESSIN 1 UNIT/ML IV INFUSION",10,154,0.0068159688412853,215,4489,0.0649350649350649,0.0478948540877701,1.35578375113259,144,4274,0.436882908323381
"1105",904,"IP ICU/CCU GENERAL ADMIT",22594,"530120","HYDROMORPHONE 10 MG IN 100 ML IV INFUSION (SHC)",22,352,0.0155793573515093,130,2894,0.0625,0.0449205252246026,1.39134615384615,330,2764,0.180090206516709
"1106",904,"IP ICU/CCU GENERAL ADMIT",22594,"540102","NS IV BOLUS",9,105,0.00464725148269452,2225,80957,0.0857142857142857,0.0274837259285794,3.11872873194222,96,78732,0.000825075790146498
"1107",904,"IP ICU/CCU GENERAL ADMIT",22594,"540106","FENTANYL (PF) 50 MCG/ML INJECTION",13,573,0.025360715234133,461,18637,0.0226876090750436,0.0247357407308043,0.917199501803879,560,18176,0.861405041745891
"1108",904,"IP ICU/CCU GENERAL ADMIT",22594,"540115","LACTATED RINGERS IV BOLUS",5,110,0.00486854917234664,400,12941,0.0454545454545455,0.0309095124024419,1.47056818181818,105,12541,0.548554848460368
"1109",904,"IP ICU/CCU GENERAL ADMIT",22594,"540744","WHITE PETROLATUM-MINERAL OIL OPHTH OINT",89,5177,0.229131627865805,46,2959,0.0171914236044041,0.0155457924974654,1.1058570096833,5088,2913,0.639218149129303
"1110",904,"IP ICU/CCU GENERAL ADMIT",22594,"540965","PIPERACILLIN-TAZOBACTAM 3.375 GRAM/50 ML MINI-BAG PLUS",27,289,0.0127910064618925,235,4195,0.0934256055363322,0.0560190703218117,1.66774644776559,262,3960,0.0126784110232515
"1111",904,"IP ICU/CCU GENERAL ADMIT",22594,"541048","HYDROMORPHONE VARIABLE DOSE INJECTION",1,44,0.00194741966893866,104,5739,0.0227272727272727,0.0181216239763025,1.2541520979021,43,5635,0.999999999999998
"1112",904,"IP ICU/CCU GENERAL ADMIT",22594,"541061","VANCOMYCIN PER PHARMACY PROTOCOL",1,145,0.00641763299991148,239,5475,0.00689655172413793,0.0436529680365297,0.157985860626172,144,5236,0.050871180088259
"1113",904,"IP ICU/CCU GENERAL ADMIT",22594,"541084","CEFEPIME 2 GRAM/100 ML MINI-BAG PLUS",2,17,0.000752412144817208,277,3459,0.117647058823529,0.0800809482509396,1.46910172011043,15,3182,0.903491721200297
"1114",904,"IP ICU/CCU GENERAL ADMIT",22594,"541085","CEFTRIAXONE 1 GRAM/50 ML MINI-BAG PLUS",1,28,0.00123926706205187,411,7130,0.0357142857142857,0.0576437587657784,0.619568995481404,27,6719,0.927691167926472
"1115",904,"IP ICU/CCU GENERAL ADMIT",22594,"541097","AZTREONAM 2 GRAM/100 ML MINI-BAG PLUS",1,9,0.000398335841373816,22,369,0.111111111111111,0.0596205962059621,1.86363636363636,8,347,1
"1116",918,"IP TRS KIDNEY AND/OR  PANCREAS RECIPIENT POSTOP",2337,"101","ACETAMINOPHEN 325 MG PO TABS",3,264,0.112965340179718,981,42092,0.0113636363636364,0.0233060914187969,0.487582244462978,261,41111,0.280504467455729
"1117",918,"IP TRS KIDNEY AND/OR  PANCREAS RECIPIENT POSTOP",2337,"664","ASCORBIC ACID 500 MG PO TABS",1,110,0.047068891741549,59,3135,0.00909090909090909,0.0188197767145136,0.483050847457627,109,3076,0.700648050749879
"1118",918,"IP TRS KIDNEY AND/OR  PANCREAS RECIPIENT POSTOP",2337,"1755","CLONIDINE HCL 0.1 MG PO TABS",2,23,0.00984167736414206,104,2839,0.0869565217391304,0.0366326171187038,2.37374581939799,21,2735,0.472435992629164
"1119",918,"IP TRS KIDNEY AND/OR  PANCREAS RECIPIENT POSTOP",2337,"1756","CLONIDINE HCL 0.2 MG PO TABS",1,21,0.00898587933247754,50,1163,0.0476190476190476,0.0429922613929493,1.10761904761905,20,1113,0.999999999999979
"1120",918,"IP TRS KIDNEY AND/OR  PANCREAS RECIPIENT POSTOP",2337,"3697","HYDRALAZINE 20 MG/ML INJ SOLN",2,273,0.116816431322208,537,15149,0.00732600732600733,0.0354478843488019,0.206669804435168,271,14612,0.019217222122169
"1121",918,"IP TRS KIDNEY AND/OR  PANCREAS RECIPIENT POSTOP",2337,"6493","PREDNISONE 1 MG PO TABS",1,3,0.00128369704749679,32,729,0.333333333333333,0.0438957475994513,7.59375,2,697,0.309124577341044
"1122",918,"IP TRS KIDNEY AND/OR  PANCREAS RECIPIENT POSTOP",2337,"6496","PREDNISONE 20 MG PO TABS",3,390,0.166880616174583,276,7517,0.00769230769230769,0.0367167753092989,0.209503901895206,387,7241,0.00387228191130221
"1123",918,"IP TRS KIDNEY AND/OR  PANCREAS RECIPIENT POSTOP",2337,"7557","SULFAMETHOXAZOLE-TRIMETHOPRIM 400-80 MG PO TABS",2,322,0.137783483097989,112,3269,0.0062111801242236,0.0342612419700214,0.181288819875776,320,3157,0.0100932660388602
"1124",918,"IP TRS KIDNEY AND/OR  PANCREAS RECIPIENT POSTOP",2337,"10181","HEPARIN (PORCINE) 5,000 UNIT/ML INJ SOLN",1,8,0.00342319212665811,156,510,0.125,0.305882352941176,0.408653846153846,7,354,0.473427343114025
"1125",918,"IP TRS KIDNEY AND/OR  PANCREAS RECIPIENT POSTOP",2337,"15861","D5 %-0.45 % SODIUM CHLORIDE IV SOLP",1,280,0.119811724433034,158,4300,0.00357142857142857,0.0367441860465116,0.0971971066907776,279,4142,0.00561157171357923
"1126",918,"IP TRS KIDNEY AND/OR  PANCREAS RECIPIENT POSTOP",2337,"81371","TACROLIMUS 5 MG PO CAPS",1,115,0.0492083868207103,25,898,0.00869565217391304,0.0278396436525612,0.312347826086956,114,873,0.363268887136621
"1127",918,"IP TRS KIDNEY AND/OR  PANCREAS RECIPIENT POSTOP",2337,"85078","MYCOPHENOLATE MOFETIL 500 MG PO TABS",1,33,0.0141206675224647,45,1479,0.0303030303030303,0.0304259634888438,0.995959595959596,32,1434,0.999999999999953
"1128",918,"IP TRS KIDNEY AND/OR  PANCREAS RECIPIENT POSTOP",2337,"94670","TACROLIMUS 1 MG PO CAPS",8,573,0.245186136071887,322,9479,0.0139616055846422,0.0339698280409326,0.41100018427585,565,9157,0.012796070483047
"1129",918,"IP TRS KIDNEY AND/OR  PANCREAS RECIPIENT POSTOP",2337,"96559","PIPERACILLIN-TAZOBACTAM-DEXTRS 3.375 GRAM/50 ML IV PGBK",6,97,0.0415062045357296,1067,10067,0.0618556701030928,0.105989867885169,0.583599841544363,91,9000,0.214316613811756
"1130",918,"IP TRS KIDNEY AND/OR  PANCREAS RECIPIENT POSTOP",2337,"110872","HYDROMORPHONE 2 MG/ML INJ SYRG",1,4,0.00171159606332905,738,23934,0.25,0.0308347956881424,8.10772357723577,3,23196,0.276385076814835
"1131",918,"IP TRS KIDNEY AND/OR  PANCREAS RECIPIENT POSTOP",2337,"112586","HYDROMORPHONE 1 MG/ML INJ SYRG",1,5,0.00213949507916132,1219,33427,0.2,0.036467526251234,5.48433141919606,4,32208,0.448816183989845
"1132",918,"IP TRS KIDNEY AND/OR  PANCREAS RECIPIENT POSTOP",2337,"198509","ONDANSETRON HCL (PF) 4 MG/2 ML INJ SOLN",1,297,0.127086007702182,705,36939,0.00336700336700337,0.0190855193697718,0.176416648757074,296,36234,0.077615537594197
"1133",918,"IP TRS KIDNEY AND/OR  PANCREAS RECIPIENT POSTOP",2337,"202606","FAMOTIDINE (PF) 20 MG/2 ML IV SOLN",16,212,0.0907145913564399,288,4280,0.0754716981132075,0.0672897196261682,1.12159329140461,196,3992,0.746780024228561
"1134",918,"IP TRS KIDNEY AND/OR  PANCREAS RECIPIENT POSTOP",2337,"209509","METHYLPREDNISOLONE SOD SUC(PF) 125 MG/2 ML INJ SOLR",13,842,0.360290971330766,275,8000,0.0154394299287411,0.034375,0.449147052472468,829,7725,0.00448042340805032
"1135",918,"IP TRS KIDNEY AND/OR  PANCREAS RECIPIENT POSTOP",2337,"212945","HEPARIN, PORCINE (PF) 5,000 UNIT/0.5 ML INJ SOLN",2,263,0.112537441163885,452,13480,0.00760456273764259,0.0335311572700297,0.22679094182173,261,13028,0.0311064054343653
"1136",918,"IP TRS KIDNEY AND/OR  PANCREAS RECIPIENT POSTOP",2337,"500017","1/2 NS WITH SODIUM BICARBONATE IV INFUSION",6,320,0.136927685066324,46,1402,0.01875,0.0328102710413695,0.571467391304348,314,1356,0.252144112607234
"1137",918,"IP TRS KIDNEY AND/OR  PANCREAS RECIPIENT POSTOP",2337,"540135","CYCLOSPORINE MODIFIED (NEORAL) 100 MG PO CAPS",1,10,0.00427899015832264,8,57,0.1,0.140350877192982,0.7125,9,49,1
"1138",918,"IP TRS KIDNEY AND/OR  PANCREAS RECIPIENT POSTOP",2337,"540492","SHC TRANSPLANT BEDSIDE MEDS HELP ORDER",7,149,0.0637569533590073,3,27,0.0469798657718121,0.111111111111111,0.422818791946309,142,24,0.382814326457375
"1139",918,"IP TRS KIDNEY AND/OR  PANCREAS RECIPIENT POSTOP",2337,"540965","PIPERACILLIN-TAZOBACTAM 3.375 GRAM/50 ML MINI-BAG PLUS",2,55,0.0235344458707745,235,4195,0.0363636363636364,0.0560190703218117,0.649129593810445,53,3960,0.737327812857295
"1140",918,"IP TRS KIDNEY AND/OR  PANCREAS RECIPIENT POSTOP",2337,"541271","PIPERACILLIN-TAZOBACTAM 3.375 GRAM/50 ML IVPB EXTENDED INFUSION",3,107,0.0457851946940522,466,8270,0.0280373831775701,0.0563482466747279,0.497573302314388,104,7804,0.291853563761605
"1141",918,"IP TRS KIDNEY AND/OR  PANCREAS RECIPIENT POSTOP",2337,"9000000","ZZZ IMS TEMPLATE",6,417,0.178433889602054,1035,28824,0.0143884892086331,0.0359075770191507,0.400708998018976,411,27789,0.0263175190578988
"1142",920,"IP TRS LIVER TRANSPLANT POSTOP",2549,"101","ACETAMINOPHEN 325 MG PO TABS",4,187,0.073362102785406,981,42092,0.0213903743315508,0.0233060914187969,0.917801871930312,183,41111,0.999999999999981
"1143",920,"IP TRS LIVER TRANSPLANT POSTOP",2549,"2508","DIPHENHYDRAMINE HCL 50 MG/ML INJ SOLN",10,475,0.186347587289133,399,16019,0.0210526315789474,0.0249079218428117,0.84521830893022,465,15620,0.701874749780684
"1144",920,"IP TRS LIVER TRANSPLANT POSTOP",2549,"5007","METOPROLOL TARTRATE 5 MG/5 ML IV SOLN",3,156,0.0612004707728521,745,12385,0.0192307692307692,0.0601534113847396,0.319695405265875,153,11640,0.0483072255517419
"1145",920,"IP TRS LIVER TRANSPLANT POSTOP",2549,"5373","NALOXONE 0.4 MG/ML INJ SOLN",5,201,0.0788544527265594,83,1774,0.0248756218905473,0.0467869222096956,0.531678954624468,196,1691,0.212556021041443
"1146",920,"IP TRS LIVER TRANSPLANT POSTOP",2549,"5751","NYSTATIN 100,000 UNIT/ML PO SUSP",1,115,0.0451157316594743,68,4056,0.00869565217391304,0.0167652859960552,0.518670076726343,114,3988,0.765438598721171
"1147",920,"IP TRS LIVER TRANSPLANT POSTOP",2549,"10050","FLUCONAZOLE IN NACL (ISO-OSM) 400 MG/200 ML IV PGBK",1,17,0.00666928207140055,40,1102,0.0588235294117647,0.0362976406533575,1.62058823529412,16,1062,0.999999999999998
"1148",920,"IP TRS LIVER TRANSPLANT POSTOP",2549,"15861","D5 %-0.45 % SODIUM CHLORIDE IV SOLP",3,185,0.0725774813652413,158,4300,0.0162162162162162,0.0367441860465116,0.44132740335272,182,4142,0.204881339913124
"1149",920,"IP TRS LIVER TRANSPLANT POSTOP",2549,"82384","PANTOPRAZOLE 40 MG IV SOLR",5,218,0.08552373479796,688,12925,0.0229357798165138,0.0532301740812379,0.430879293791338,213,12237,0.0669612949388706
"1150",920,"IP TRS LIVER TRANSPLANT POSTOP",2549,"94670","TACROLIMUS 1 MG PO CAPS",2,63,0.0247155747351903,322,9479,0.0317460317460317,0.0339698280409326,0.934536133293897,61,9157,0.999999999999521
"1151",920,"IP TRS LIVER TRANSPLANT POSTOP",2549,"96559","PIPERACILLIN-TAZOBACTAM-DEXTRS 3.375 GRAM/50 ML IV PGBK",16,104,0.0408003138485681,1067,10067,0.153846153846154,0.105989867885169,1.45151755461034,88,9000,0.157258339862497
"1152",920,"IP TRS LIVER TRANSPLANT POSTOP",2549,"110872","HYDROMORPHONE 2 MG/ML INJ SYRG",1,21,0.00823852491173009,738,23934,0.0476190476190476,0.0308347956881424,1.54432830042586,20,23196,0.999999999999994
"1153",920,"IP TRS LIVER TRANSPLANT POSTOP",2549,"209037","ACETAMINOPHEN 650 MG/20.3 ML PO SOLN",14,321,0.125931737936446,192,8611,0.043613707165109,0.0222970618975729,1.95602933541018,307,8419,0.0209507700165365
"1154",920,"IP TRS LIVER TRANSPLANT POSTOP",2549,"210379","HYDROCORTISONE SOD SUCC (PF) 100 MG/2 ML INJ SOLR",6,474,0.185955276579051,313,9164,0.0126582278481013,0.0341553906591008,0.370607028753994,468,8851,0.0155445201618769
"1155",920,"IP TRS LIVER TRANSPLANT POSTOP",2549,"520045","MEROPENEM CUSTOM IVPB",1,1,0.000392310710082385,100,1654,1,0.060459492140266,16.54,0,1554,0.0666030171596958
"1156",920,"IP TRS LIVER TRANSPLANT POSTOP",2549,"520074","ANTITHYMOCYTE GLOBULIN RABBIT IVPB",15,520,0.20400156924284,75,1781,0.0288461538461538,0.0421111734980348,0.685,505,1706,0.213436953816056
"1157",920,"IP TRS LIVER TRANSPLANT POSTOP",2549,"530006","EPINEPHRINE IV INFUSION",1,24,0.00941545704197725,99,2540,0.0416666666666667,0.0389763779527559,1.06902356902357,23,2441,0.999999999999904
"1158",920,"IP TRS LIVER TRANSPLANT POSTOP",2549,"530008","NITROPRUSSIDE IV INFUSION",1,98,0.0384464495880738,79,2082,0.0102040816326531,0.0379442843419789,0.268922758977009,97,2003,0.249120605160857
"1159",920,"IP TRS LIVER TRANSPLANT POSTOP",2549,"530012","PHENYLEPHRINE IV INFUSION",1,36,0.0141231855629659,61,2180,0.0277777777777778,0.0279816513761468,0.992714025500911,35,2119,0.999999999999999
"1160",920,"IP TRS LIVER TRANSPLANT POSTOP",2549,"540106","FENTANYL (PF) 50 MCG/ML INJECTION",4,134,0.0525696351510396,461,18637,0.0298507462686567,0.0247357407308043,1.20678602648363,130,18176,0.919796320410462
"1161",920,"IP TRS LIVER TRANSPLANT POSTOP",2549,"540129","TACROLIMUS 1 MG/ML ORAL SUSPENSION",24,433,0.169870537465673,147,4881,0.0554272517321016,0.0301167793484942,1.84041099118631,409,4734,0.00656430308550519
"1162",920,"IP TRS LIVER TRANSPLANT POSTOP",2549,"540960","MEROPENEM IN NS 1 GRAM/100 ML MINI-BAG PLUS",2,5,0.00196155355041193,302,3726,0.4,0.0810520665593129,4.93509933774834,3,3424,0.0738874555304097
"1163",920,"IP TRS LIVER TRANSPLANT POSTOP",2549,"540965","PIPERACILLIN-TAZOBACTAM 3.375 GRAM/50 ML MINI-BAG PLUS",1,67,0.0262848175755198,235,4195,0.0149253731343284,0.0560190703218117,0.266433788504287,66,3960,0.234080545732343
"1164",920,"IP TRS LIVER TRANSPLANT POSTOP",2549,"541271","PIPERACILLIN-TAZOBACTAM 3.375 GRAM/50 ML IVPB EXTENDED INFUSION",4,102,0.0400156924284033,466,8270,0.0392156862745098,0.0563482466747279,0.695952200622738,98,7804,0.595629650423754
"1165",920,"IP TRS LIVER TRANSPLANT POSTOP",2549,"9000000","ZZZ IMS TEMPLATE",2,38,0.0149078069831306,1035,28824,0.0526315789473684,0.0359075770191507,1.46575133485889,36,27789,0.906492996491915
"1166",921,"IP TRS KIDNEY TRANSPLANT  BIOPSY POSTOP",147,"102","ACETAMINOPHEN 500 MG PO TABS",1,27,0.183673469387755,392,15968,0.037037037037037,0.0245490981963928,1.50869236583522,26,15576,0.999999999999152
"1167",921,"IP TRS KIDNEY TRANSPLANT  BIOPSY POSTOP",147,"5002","METOCLOPRAMIDE HCL 5 MG/ML INJ SOLN",2,35,0.238095238095238,346,10128,0.0571428571428571,0.0341627172195893,1.67266721717589,33,9782,0.778892148690187
"1168",921,"IP TRS KIDNEY TRANSPLANT  BIOPSY POSTOP",147,"34505","HYDROCODONE-ACETAMINOPHEN 5-325 MG PO TABS",2,34,0.231292517006803,603,24164,0.0588235294117647,0.0249544777354743,2.35723344063994,32,23561,0.474978820653102
"1169",921,"IP TRS KIDNEY TRANSPLANT  BIOPSY POSTOP",147,"198509","ONDANSETRON HCL (PF) 4 MG/2 ML INJ SOLN",1,40,0.272108843537415,705,36939,0.025,0.0190855193697718,1.30989361702128,39,36234,0.999999999999993
"1170",922,"IP TRS LIVER TRANSPLANT PREOP",137,"25365","CEFAZOLIN IN DEXTROSE (ISO-OS) 1 GRAM/50 ML IV PGBK",1,7,0.0510948905109489,258,5335,0.142857142857143,0.0483598875351453,2.95404208194906,6,5077,0.777313352992631
"1171",927,"IP GEN CONSTIPATION",629,"1080","BISACODYL 10 MG PR SUPP",2,372,0.591414944356121,344,22442,0.00537634408602151,0.0153284021031994,0.350743935983996,370,22098,0.178989654502174
"1172",927,"IP GEN CONSTIPATION",629,"2566","DOCUSATE SODIUM 100 MG PO CAPS",6,183,0.29093799682035,542,37509,0.0327868852459016,0.0144498653656456,2.26900973927772,177,36967,0.0787813446024106
"1173",927,"IP GEN CONSTIPATION",629,"11349","SENNOSIDES 8.6 MG PO TABS",5,219,0.348171701112878,610,35793,0.0228310502283105,0.0170424384656218,1.33965865708511,214,35183,0.6909289204608
"1174",927,"IP GEN CONSTIPATION",629,"13632","BISACODYL 5 MG PO TBEC",2,234,0.372019077901431,49,3268,0.00854700854700855,0.0149938800489596,0.570033141461713,232,3219,0.608096134829171
"1175",927,"IP GEN CONSTIPATION",629,"25424","POLYETHYLENE GLYCOL 3350 17 GRAM PO PWPK",7,288,0.457869634340223,712,36910,0.0243055555555556,0.0192901652668653,1.2599972690387,281,36198,0.688434795027657
"1176",927,"IP GEN CONSTIPATION",629,"90206","SODIUM PHOSPHATES 19-7 GRAM/118 ML PR ENEM",1,174,0.276629570747218,101,3581,0.00574712643678161,0.02820441217537,0.20376692841698,173,3480,0.123366906550634
"1177",927,"IP GEN CONSTIPATION",629,"230523","PSYLLIUM HUSK 6 GRAM PO PWPK",2,39,0.0620031796502385,26,1435,0.0512820512820513,0.0181184668989547,2.83037475345168,37,1409,0.366780065003667
"1178",932,"IP/ED GEN HYPERKALEMIA THERAPY",1546,"250","ALBUTEROL SULFATE 2.5 MG /3 ML (0.083 %) INH NEBU",12,207,0.133893919793014,106,3939,0.0579710144927536,0.0269103833460269,2.15422477440525,195,3833,0.0161688728819056
"1179",932,"IP/ED GEN HYPERKALEMIA THERAPY",1546,"2365","DEXTROSE 50 % IN WATER (D50W) IV SYRG",23,607,0.392626131953428,134,3551,0.0378912685337726,0.0377358490566038,1.00411861614498,584,3417,0.999999999999998
"1180",932,"IP/ED GEN HYPERKALEMIA THERAPY",1546,"3291","FUROSEMIDE 10 MG/ML INJ SOLN",3,111,0.0717981888745149,1985,57715,0.027027027027027,0.0343931386987785,0.785826128395398,108,55730,0.869092346426563
"1181",932,"IP/ED GEN HYPERKALEMIA THERAPY",1546,"27838","SODIUM CHLORIDE 0.9 % 0.9 % IV SOLP",4,57,0.036869340232859,692,19620,0.0701754385964912,0.0352701325178389,1.98965622147855,53,18928,0.286626909013089
"1182",932,"IP/ED GEN HYPERKALEMIA THERAPY",1546,"27999","SODIUM POLYSTYRENE SULFONATE 15 GRAM/60 ML PO SUSP",26,263,0.170116429495472,177,2440,0.0988593155893536,0.0725409836065574,1.36280638439561,237,2263,0.156918625107138
"1183",932,"IP/ED GEN HYPERKALEMIA THERAPY",1546,"88904","INSULIN REGULAR HUMAN 100 UNIT/ML INJ SOLN",29,633,0.409443725743855,482,5722,0.0458135860979463,0.0842362810206222,0.543869999278939,604,5240,0.000979718876657221
"1184",932,"IP/ED GEN HYPERKALEMIA THERAPY",1546,"112517","SODIUM BICARBONATE 8.4 % (1 MEQ/ML) IV SYRG",10,132,0.0853816300129366,65,2665,0.0757575757575758,0.024390243902439,3.10606060606061,122,2600,0.00100147610841819
"1185",932,"IP/ED GEN HYPERKALEMIA THERAPY",1546,"211084","CALCIUM GLUCONATE IN 0.9% NACL 1 GRAM/50 ML IV SOLN",19,389,0.251617076326003,326,12268,0.0488431876606684,0.0265731985653733,1.83806204362294,370,11942,0.0125062355173994
"1186",932,"IP/ED GEN HYPERKALEMIA THERAPY",1546,"221562","CALCIUM CHLORIDE 1 GRAM (13.6 MEQ)/50 ML NS IVPB",9,40,0.0258732212160414,156,2315,0.225,0.0673866090712743,3.33894230769231,31,2159,0.000371462526406656
"1187",932,"IP/ED GEN HYPERKALEMIA THERAPY",1546,"520097","SODIUM BICARBONATE IVPB",11,72,0.0465717981888745,69,856,0.152777777777778,0.080607476635514,1.89533011272142,61,787,0.0605281673261796
"1188",932,"IP/ED GEN HYPERKALEMIA THERAPY",1546,"540775","POLYETHYLENE GLYCOL 3350 17 GM (FOR KAYEXALATE PANEL)",13,142,0.091849935316947,151,2483,0.0915492957746479,0.0608135320177205,1.50540994310232,129,2332,0.195807153029078
"1189",934,"IP ELECTROLYTE REPLACEMENT SCALES",15206,"6427","POTASSIUM CHLORIDE 10 MEQ/100 ML IV PGBK",1,24,0.00157832434565303,1228,18599,0.0416666666666667,0.0660250551104898,0.631073561346363,23,17371,0.945003323200909
"1190",934,"IP ELECTROLYTE REPLACEMENT SCALES",15206,"6432","POTASSIUM CHLORIDE 20 MEQ/15 ML PO LIQD",72,2673,0.175785873997106,425,8090,0.0269360269360269,0.0525339925834363,0.512735195088136,2601,7665,6.16065469076659e-08
"1191",934,"IP ELECTROLYTE REPLACEMENT SCALES",15206,"35943","POTASSIUM CHLORIDE 20 MEQ PO TBTQ",1,2,0.000131527028804419,1006,28886,0.5,0.0348265595790348,14.3568588469185,1,27880,0.0971497641435672
"1192",934,"IP ELECTROLYTE REPLACEMENT SCALES",15206,"126992","LIDOCAINE (PF) 10 MG/ML (1 %) INJ SOLN",73,3979,0.261673023806392,457,11068,0.0183463181703946,0.0412902059992772,0.444326147724129,3906,10611,2.33610081016045e-11
"1193",934,"IP ELECTROLYTE REPLACEMENT SCALES",15206,"211084","CALCIUM GLUCONATE IN 0.9% NACL 1 GRAM/50 ML IV SOLN",48,4187,0.275351834802052,326,12268,0.0114640554096011,0.0265731985653733,0.431414207868058,4139,11942,2.09334228676735e-08
"1194",934,"IP ELECTROLYTE REPLACEMENT SCALES",15206,"221562","CALCIUM CHLORIDE 1 GRAM (13.6 MEQ)/50 ML NS IVPB",143,1690,0.111140339339734,156,2315,0.0846153846153846,0.0673866090712743,1.25567061143984,1547,2159,0.0468258271554514
"1195",934,"IP ELECTROLYTE REPLACEMENT SCALES",15206,"500006","SODIUM PHOSPHATE IVPB",25,468,0.0307773247402341,296,4785,0.0534188034188034,0.0618599791013584,0.863543832293832,443,4489,0.530972186213114
"1196",934,"IP ELECTROLYTE REPLACEMENT SCALES",15206,"540301","POTASSIUM CHLORIDE ORAL SCALE",101,4147,0.272721294225963,105,3653,0.0243549553894381,0.0287434984943882,0.847320495596358,4046,3548,0.256221895594361
"1197",934,"IP ELECTROLYTE REPLACEMENT SCALES",15206,"540302","POTASSIUM CHLORIDE IV SCALE",188,6537,0.429896093647245,150,4660,0.0287593697414716,0.0321888412017167,0.893457753301719,6349,4510,0.322451220140277
"1198",934,"IP ELECTROLYTE REPLACEMENT SCALES",15206,"540304","MAGNESIUM SULFATE IV SCALE ",135,7601,0.499868472971196,78,4104,0.0177608209446126,0.0190058479532164,0.934492425085768,7466,4026,0.682982522218742
"1199",944,"IP GI ENDOSCOPY PRE/POSTOP PROCEDURE",10114,"2508","DIPHENHYDRAMINE HCL 50 MG/ML INJ SOLN",16,989,0.0977852481708523,399,16019,0.0161779575328615,0.0249079218428117,0.64951053062383,973,15620,0.105076893071504
"1200",944,"IP GI ENDOSCOPY PRE/POSTOP PROCEDURE",10114,"4448","LIDOCAINE HCL 2 % JELLY",1,137,0.0135455803836267,66,3270,0.0072992700729927,0.0201834862385321,0.361645653616457,136,3204,0.453239801108443
"1201",944,"IP GI ENDOSCOPY PRE/POSTOP PROCEDURE",10114,"5373","NALOXONE 0.4 MG/ML INJ SOLN",2,175,0.0173027486652165,83,1774,0.0114285714285714,0.0467869222096956,0.244268502581756,173,1691,0.0464733423132068
"1202",944,"IP GI ENDOSCOPY PRE/POSTOP PROCEDURE",10114,"7228","SIMETHICONE 40 MG/0.6 ML PO DRPS",7,638,0.0630808779909037,18,574,0.0109717868338558,0.0313588850174216,0.349878091257402,631,556,0.0219668654467539
"1203",944,"IP GI ENDOSCOPY PRE/POSTOP PROCEDURE",10114,"10055","FLUMAZENIL 0.1 MG/ML IV SOLN",1,163,0.0161162744710303,14,238,0.00613496932515337,0.0588235294117647,0.104294478527607,162,224,0.0137715954875524
"1204",944,"IP GI ENDOSCOPY PRE/POSTOP PROCEDURE",10114,"10607","MIDAZOLAM 1 MG/ML INJ SOLN",27,2799,0.276745105793949,155,5616,0.00964630225080386,0.0275997150997151,0.349507312519448,2772,5461,1.48238941005652e-07
"1205",944,"IP GI ENDOSCOPY PRE/POSTOP PROCEDURE",10114,"27838","SODIUM CHLORIDE 0.9 % 0.9 % IV SOLP",69,4963,0.490705952145541,692,19620,0.0139028813217812,0.0352701325178389,0.394182849036628,4894,18928,1.17704515691033e-14
"1206",944,"IP GI ENDOSCOPY PRE/POSTOP PROCEDURE",10114,"79552","INDOMETHACIN 50 MG PR SUPP",1,36,0.00355942258255883,4,121,0.0277777777777778,0.0330578512396694,0.840277777777778,35,117,1
"1207",944,"IP GI ENDOSCOPY PRE/POSTOP PROCEDURE",10114,"81505","CIPROFLOXACIN IN D5W 400 MG/200 ML IV PGBK",1,64,0.00632786236899347,242,3682,0.015625,0.0657251493753395,0.237732438016529,63,3440,0.174652765989568
"1208",944,"IP GI ENDOSCOPY PRE/POSTOP PROCEDURE",10114,"82190","BUTAMBEN-TETRACAINE-BENZOCAINE 2-2-14 % TP SPRA",3,637,0.0629820051413882,12,304,0.00470957613814757,0.0394736842105263,0.119309262166405,634,292,0.000212622177597693
"1209",944,"IP GI ENDOSCOPY PRE/POSTOP PROCEDURE",10114,"90788","LIDOCAINE HCL 2 % VISCOUS ORAL SOLN",2,251,0.0248170852283963,77,1939,0.00796812749003984,0.0397111913357401,0.200651937703731,249,1862,0.0183823555104757
"1210",944,"IP GI ENDOSCOPY PRE/POSTOP PROCEDURE",10114,"222816","LIDOCAINE 5 % TP OINT",4,52,0.0051413881748072,26,543,0.0769230769230769,0.0478821362799263,1.60650887573965,48,517,0.56017357158383
"1211",944,"IP GI ENDOSCOPY PRE/POSTOP PROCEDURE",10114,"540106","FENTANYL (PF) 50 MCG/ML INJECTION",33,2789,0.275756377298794,461,18637,0.0118321979204016,0.0247357407308043,0.478344192283133,2756,18176,3.08548829943551e-05
"1212",944,"IP GI ENDOSCOPY PRE/POSTOP PROCEDURE",10114,"540303","MEPERIDINE INJECTABLE SYRINGE",1,30,0.00296618548546569,5,60,0.0333333333333333,0.0833333333333333,0.4,29,55,0.654001120664955
"1213",944,"IP GI ENDOSCOPY PRE/POSTOP PROCEDURE",10114,"540548","GLUCAGON 1 MG (1 UNIT) INJ SOLR",1,273,0.0269922879177378,16,252,0.00366300366300366,0.0634920634920635,0.0576923076923077,272,236,0.000291875729669113
"1214",944,"IP GI ENDOSCOPY PRE/POSTOP PROCEDURE",10114,"541092","AMPICILLIN 2 GRAM/100 ML MINI-BAG PLUS",1,3,0.000296618548546569,29,480,0.333333333333333,0.0604166666666667,5.51724137931034,2,451,0.4516580154346
"1215",944,"IP GI ENDOSCOPY PRE/POSTOP PROCEDURE",10114,"541105","CEFOXITIN 2 GRAM/50 ML MINI-BAG PLUS",2,17,0.00168083844176389,25,530,0.117647058823529,0.0471698113207547,2.49411764705882,15,505,0.452219553738857
"1216",946,"IP PAI PATIENT CONTROLLED ANALGESIA (PCA)",37671,"5373","NALOXONE 0.4 MG/ML INJ SOLN",267,11746,0.311804836611717,83,1774,0.0227311425166014,0.0467869222096956,0.485843937643986,11479,1691,4.44118086500507e-09
"1217",946,"IP PAI PATIENT CONTROLLED ANALGESIA (PCA)",37671,"110872","HYDROMORPHONE 2 MG/ML INJ SYRG",5,327,0.00868041729712511,738,23934,0.0152905198776758,0.0308347956881424,0.495885234081699,322,23196,0.144622271901603
"1218",946,"IP PAI PATIENT CONTROLLED ANALGESIA (PCA)",37671,"112586","HYDROMORPHONE 1 MG/ML INJ SYRG",2,75,0.00199092139842319,1219,33427,0.0266666666666667,0.036467526251234,0.731244189226142,73,32208,0.885508592855815
"1219",946,"IP PAI PATIENT CONTROLLED ANALGESIA (PCA)",37671,"207949","MORPHINE (PF) 30 MG/30 ML (1 MG/ML) IV PCA",25,580,0.0153964588144727,59,774,0.0431034482758621,0.0762273901808786,0.565458796025716,555,715,0.0170105948138206
"1220",946,"IP PAI PATIENT CONTROLLED ANALGESIA (PCA)",37671,"540101","FENTANYL 50 MCG/ML IV PCA",66,1940,0.0514985001725465,39,965,0.034020618556701,0.0404145077720207,0.841792228390166,1874,926,0.444810585162447
"1221",946,"IP PAI PATIENT CONTROLLED ANALGESIA (PCA)",37671,"540106","FENTANYL (PF) 50 MCG/ML INJECTION",4,127,0.0033712935679966,461,18637,0.031496062992126,0.0247357407308043,1.27330179172289,123,18176,0.839889921209452
"1222",946,"IP PAI PATIENT CONTROLLED ANALGESIA (PCA)",37671,"540125","HYDROMORPHONE 1 MG/ML IV PCA",302,11475,0.304610973958748,338,7089,0.026318082788671,0.0476795034560587,0.55197896120973,11173,6751,1.26751183226826e-14
"1223",946,"IP PAI PATIENT CONTROLLED ANALGESIA (PCA)",37671,"541605","FENTANYL 50 MCG/ML IV PCA",45,831,0.0220594090945289,11,240,0.0541516245487365,0.0458333333333333,1.18148999015425,786,229,0.729846094621287
"1224",946,"IP PAI PATIENT CONTROLLED ANALGESIA (PCA)",37671,"541607","HYDROMORPHONE 1 MG/ML IV PCA",221,4934,0.1309760823976,124,1939,0.0447912444264289,0.0639504899432697,0.700405023732625,4713,1815,0.00131660612884581
"1225",946,"IP PAI PATIENT CONTROLLED ANALGESIA (PCA)",37671,"541609","MORPHINE 30 MG/30 ML IV PCA",15,214,0.0056807623901675,12,223,0.0700934579439252,0.0538116591928251,1.30257009345794,199,211,0.611480367775465
"1226",947,"CDU DEHYDRATION OBSERVATION",56,"15861","D5 %-0.45 % SODIUM CHLORIDE IV SOLP",3,16,0.285714285714286,158,4300,0.1875,0.0367441860465116,5.10284810126582,13,4142,0.011890582399978
"1227",947,"CDU DEHYDRATION OBSERVATION",56,"112586","HYDROMORPHONE 1 MG/ML INJ SYRG",1,3,0.0535714285714286,1219,33427,0.333333333333333,0.036467526251234,9.14055236532677,2,32208,0.229196268956555
"1228",950,"CDU PYELONEPHRITIS OBSERVATION",122,"541085","CEFTRIAXONE 1 GRAM/50 ML MINI-BAG PLUS",1,6,0.0491803278688525,411,7130,0.166666666666667,0.0576437587657784,2.89132197891322,5,6719,0.787975986634405
"1229",951,"CDU KIDNEY STONE OBSERVATION",6,"86943","TAMSULOSIN 0.4 MG PO CP24",1,1,0.166666666666667,238,11835,1,0.0201098436839882,49.7268907563025,0,11597,0.000646566653151083
"1230",956,"CDU CLOSED HEAD INJURY OBSERVATION",45,"101","ACETAMINOPHEN 325 MG PO TABS",1,5,0.111111111111111,981,42092,0.2,0.0233060914187969,8.58144750254842,4,41111,0.255989696965087
"1231",956,"CDU CLOSED HEAD INJURY OBSERVATION",45,"15861","D5 %-0.45 % SODIUM CHLORIDE IV SOLP",1,8,0.177777777777778,158,4300,0.125,0.0367441860465116,3.40189873417722,7,4142,0.700764929972869
"1232",957,"CDU SYNCOPE OBSERVATION",74,"27838","SODIUM CHLORIDE 0.9 % 0.9 % IV SOLP",1,5,0.0675675675675676,692,19620,0.2,0.0352701325178389,5.67052023121387,4,18928,0.43315438725597
"1233",957,"CDU SYNCOPE OBSERVATION",74,"34505","HYDROCODONE-ACETAMINOPHEN 5-325 MG PO TABS",1,2,0.027027027027027,603,24164,0.5,0.0249544777354743,20.0364842454395,1,23561,0.0415013714707364
"1234",957,"CDU SYNCOPE OBSERVATION",74,"92173","ZOLPIDEM 5 MG PO TABS",1,9,0.121621621621622,159,8203,0.111111111111111,0.019383152505181,5.73235499650594,8,8044,0.433411779437914
"1235",958,"CDU CELLULITIS OBSERVATION",159,"101","ACETAMINOPHEN 325 MG PO TABS",3,23,0.144654088050314,981,42092,0.130434782608696,0.0233060914187969,5.59659619731419,20,41111,0.00673148764119779
"1236",958,"CDU CELLULITIS OBSERVATION",159,"9627","CLINDAMYCIN IN DEXTROSE 5% 900 MG/50 ML IV PGBK",1,4,0.0251572327044025,29,474,0.25,0.0611814345991561,4.08620689655172,3,445,0.606275443907692
"1237",958,"CDU CELLULITIS OBSERVATION",159,"92173","ZOLPIDEM 5 MG PO TABS",1,32,0.20125786163522,159,8203,0.03125,0.019383152505181,1.6122248427673,31,8044,0.999999999999998
"1238",958,"CDU CELLULITIS OBSERVATION",159,"124216","VANCOMYCIN IN D5W 1 GRAM/200 ML IV PGBK",2,6,0.0377358490566038,1951,16917,0.333333333333333,0.115327776792576,2.89031266017427,4,14966,0.302053233450265
"1239",958,"CDU CELLULITIS OBSERVATION",159,"198509","ONDANSETRON HCL (PF) 4 MG/2 ML INJ SOLN",1,71,0.446540880503145,705,36939,0.0140845070422535,0.0190855193697718,0.737968234941564,70,36234,0.999999999999974
"1240",959,"CDU ASTHMA OBSERVATION",103,"250","ALBUTEROL SULFATE 2.5 MG /3 ML (0.083 %) INH NEBU",4,25,0.242718446601942,106,3939,0.16,0.0269103833460269,5.94566037735849,21,3833,0.000608544230157317
"1241",959,"CDU ASTHMA OBSERVATION",103,"12580","IPRATROPIUM BROMIDE 0.02 % INH SOLN",4,25,0.242718446601942,127,3899,0.16,0.0325724544755065,4.91212598425197,21,3772,0.00291070104984472
"1242",959,"CDU ASTHMA OBSERVATION",103,"9000000","ZZZ IMS TEMPLATE",1,15,0.145631067961165,1035,28824,0.0666666666666667,0.0359075770191507,1.85661835748792,14,27789,0.999999999999337
"1243",960,"CDU ABDOMINAL PAIN OBSERVATION",253,"5002","METOCLOPRAMIDE HCL 5 MG/ML INJ SOLN",2,9,0.0355731225296443,346,10128,0.222222222222222,0.0341627172195893,6.50481695568401,7,9782,0.0291498670524629
"1244",960,"CDU ABDOMINAL PAIN OBSERVATION",253,"5940","OXYCODONE-ACETAMINOPHEN 5-325 MG PO TABS",1,5,0.0197628458498024,218,7862,0.2,0.0277283134062579,7.21284403669725,4,7644,0.326507028774615
"1245",960,"CDU ABDOMINAL PAIN OBSERVATION",253,"15861","D5 %-0.45 % SODIUM CHLORIDE IV SOLP",4,59,0.233201581027668,158,4300,0.0677966101694915,0.0367441860465116,1.84509761853679,55,4142,0.365003688313926
"1246",960,"CDU ABDOMINAL PAIN OBSERVATION",253,"27838","SODIUM CHLORIDE 0.9 % 0.9 % IV SOLP",2,29,0.114624505928854,692,19620,0.0689655172413793,0.0352701325178389,1.95535180386685,27,18928,0.63198565991831
"1247",960,"CDU ABDOMINAL PAIN OBSERVATION",253,"34505","HYDROCODONE-ACETAMINOPHEN 5-325 MG PO TABS",1,11,0.0434782608695652,603,24164,0.0909090909090909,0.0249544777354743,3.64299713553445,10,23561,0.663501364559018
"1248",960,"CDU ABDOMINAL PAIN OBSERVATION",253,"112586","HYDROMORPHONE 1 MG/ML INJ SYRG",1,15,0.0592885375494071,1219,33427,0.0666666666666667,0.036467526251234,1.82811047306535,14,32208,0.999999999999995
"1249",960,"CDU ABDOMINAL PAIN OBSERVATION",253,"198509","ONDANSETRON HCL (PF) 4 MG/2 ML INJ SOLN",1,121,0.478260869565217,705,36939,0.00826446280991736,0.0190855193697718,0.433022683312819,120,36234,0.591775289384449
"1250",961,"CDU CHEST PAIN OBSERVATION",336,"680","ASPIRIN 81 MG PO CHEW",1,8,0.0238095238095238,357,11203,0.125,0.031866464339909,3.92261904761905,7,10846,0.622786012463415
"1251",961,"CDU CHEST PAIN OBSERVATION",336,"5604","NITROGLYCERIN 0.4 MG SL SUBL",2,117,0.348214285714286,77,2947,0.0170940170940171,0.0261282660332542,0.654234654234654,115,2870,0.758618254529157
"1252",961,"CDU CHEST PAIN OBSERVATION",336,"92173","ZOLPIDEM 5 MG PO TABS",3,67,0.199404761904762,159,8203,0.0447761194029851,0.019383152505181,2.31005350605463,64,8044,0.293183438040247
"1253",962,"CDU GENERAL  PROTOCOL OBSERVATION",1009,"101","ACETAMINOPHEN 325 MG PO TABS",1,118,0.116947472745292,981,42092,0.00847457627118644,0.0233060914187969,0.363620656887645,117,41111,0.446349343974249
"1254",962,"CDU GENERAL  PROTOCOL OBSERVATION",1009,"3845","IBUPROFEN 800 MG PO TABS",1,4,0.00396432111000991,25,565,0.25,0.0442477876106195,5.65,3,540,0.445915943407428
"1255",962,"CDU GENERAL  PROTOCOL OBSERVATION",1009,"5940","OXYCODONE-ACETAMINOPHEN 5-325 MG PO TABS",2,42,0.0416253716551041,218,7862,0.0476190476190476,0.0277283134062579,1.71734381826125,40,7644,0.755580249102666
"1256",962,"CDU GENERAL  PROTOCOL OBSERVATION",1009,"27838","SODIUM CHLORIDE 0.9 % 0.9 % IV SOLP",2,60,0.0594648166501487,692,19620,0.0333333333333333,0.0352701325178389,0.945086705202312,58,18928,0.999999999999305
"1257",962,"CDU GENERAL  PROTOCOL OBSERVATION",1009,"92173","ZOLPIDEM 5 MG PO TABS",12,191,0.189296333002973,159,8203,0.06282722513089,0.019383152505181,3.24133162106095,179,8044,8.06566292922893e-05
"1258",962,"CDU GENERAL  PROTOCOL OBSERVATION",1009,"110872","HYDROMORPHONE 2 MG/ML INJ SYRG",3,26,0.0257680872150644,738,23934,0.115384615384615,0.0308347956881424,3.74202626641651,23,23196,0.0545754568363725
"1259",962,"CDU GENERAL  PROTOCOL OBSERVATION",1009,"198509","ONDANSETRON HCL (PF) 4 MG/2 ML INJ SOLN",9,436,0.43211100099108,705,36939,0.0206422018348624,0.0190855193697718,1.08156353699004,427,36234,0.952071810352023
"1260",962,"CDU GENERAL  PROTOCOL OBSERVATION",1009,"9000000","ZZZ IMS TEMPLATE",1,4,0.00396432111000991,1035,28824,0.25,0.0359075770191507,6.96231884057971,3,27789,0.338546273868797
"1261",965,"CDU PNEUMONIA OBSERVATION",128,"15861","D5 %-0.45 % SODIUM CHLORIDE IV SOLP",1,4,0.03125,158,4300,0.25,0.0367441860465116,6.80379746835443,3,4142,0.350233555143549
"1262",972,"IP PLS BREAST RECONSTRUCT UNILAT/BILATERAL  FREE TRAM FLAP",1068,"101","ACETAMINOPHEN 325 MG PO TABS",2,107,0.100187265917603,981,42092,0.0186915887850467,0.0233060914187969,0.802004439490506,105,41111,0.9999999999999
"1263",972,"IP PLS BREAST RECONSTRUCT UNILAT/BILATERAL  FREE TRAM FLAP",1068,"663","ASCORBIC ACID 250 MG PO TABS",1,7,0.00655430711610487,39,2351,0.142857142857143,0.0165886856656742,8.61172161172161,6,2312,0.26375639320522
"1264",972,"IP PLS BREAST RECONSTRUCT UNILAT/BILATERAL  FREE TRAM FLAP",1068,"664","ASCORBIC ACID 500 MG PO TABS",1,232,0.217228464419476,59,3135,0.00431034482758621,0.0188197767145136,0.229032729398013,231,3076,0.175491207942454
"1265",972,"IP PLS BREAST RECONSTRUCT UNILAT/BILATERAL  FREE TRAM FLAP",1068,"2566","DOCUSATE SODIUM 100 MG PO CAPS",1,231,0.216292134831461,542,37509,0.00432900432900433,0.0144498653656456,0.29958786600853,230,36967,0.312177110018948
"1266",972,"IP PLS BREAST RECONSTRUCT UNILAT/BILATERAL  FREE TRAM FLAP",1068,"3074","FERROUS SULFATE 325 MG (65 MG IRON) PO TABS",1,162,0.151685393258427,97,6557,0.00617283950617284,0.0147933506176605,0.417271223113148,161,6460,0.567043408268712
"1267",972,"IP PLS BREAST RECONSTRUCT UNILAT/BILATERAL  FREE TRAM FLAP",1068,"4573","LORAZEPAM 1 MG PO TABS",1,32,0.0299625468164794,337,8494,0.03125,0.0396750647515894,0.787648367952522,31,8157,0.999999999999994
"1268",972,"IP PLS BREAST RECONSTRUCT UNILAT/BILATERAL  FREE TRAM FLAP",1068,"5002","METOCLOPRAMIDE HCL 5 MG/ML INJ SOLN",4,309,0.289325842696629,346,10128,0.0129449838187702,0.0341627172195893,0.378921376059263,305,9782,0.0600442688592135
"1269",972,"IP PLS BREAST RECONSTRUCT UNILAT/BILATERAL  FREE TRAM FLAP",1068,"14863","POTASSIUM CHLORID-D5-0.45%NACL 20 MEQ/L IV SOLP",2,332,0.310861423220974,314,8762,0.00602409638554217,0.035836566993837,0.168099148185097,330,8448,0.00580190528799988
"1270",972,"IP PLS BREAST RECONSTRUCT UNILAT/BILATERAL  FREE TRAM FLAP",1068,"25365","CEFAZOLIN IN DEXTROSE (ISO-OS) 1 GRAM/50 ML IV PGBK",2,212,0.198501872659176,258,5335,0.00943396226415094,0.0483598875351453,0.195078250694749,210,5077,0.0137369621611587
"1271",972,"IP PLS BREAST RECONSTRUCT UNILAT/BILATERAL  FREE TRAM FLAP",1068,"82384","PANTOPRAZOLE 40 MG IV SOLR",1,13,0.0121722846441948,688,12925,0.0769230769230769,0.0532301740812379,1.44510286225403,12,12237,0.999999999999887
"1272",972,"IP PLS BREAST RECONSTRUCT UNILAT/BILATERAL  FREE TRAM FLAP",1068,"198509","ONDANSETRON HCL (PF) 4 MG/2 ML INJ SOLN",5,330,0.308988764044944,705,36939,0.0151515151515152,0.0190855193697718,0.793874919406834,325,36234,0.75032256166878
"1273",972,"IP PLS BREAST RECONSTRUCT UNILAT/BILATERAL  FREE TRAM FLAP",1068,"202606","FAMOTIDINE (PF) 20 MG/2 ML IV SOLN",2,18,0.0168539325842697,288,4280,0.111111111111111,0.0672897196261682,1.65123456790123,16,3992,0.788070488790243
"1274",972,"IP PLS BREAST RECONSTRUCT UNILAT/BILATERAL  FREE TRAM FLAP",1068,"520064","CEFAZOLIN 2 G IVPB",1,32,0.0299625468164794,109,2674,0.03125,0.0407629020194465,0.766628440366972,31,2565,0.999999999999996
"1275",972,"IP PLS BREAST RECONSTRUCT UNILAT/BILATERAL  FREE TRAM FLAP",1068,"540598","THERAPEUTIC MULTIVITAMIN & MINERALS (GENERIC) PO TABS",1,246,0.230337078651685,17,1250,0.0040650406504065,0.0136,0.298900047824008,245,1233,0.350331044586876
"1276",972,"IP PLS BREAST RECONSTRUCT UNILAT/BILATERAL  FREE TRAM FLAP",1068,"541048","HYDROMORPHONE VARIABLE DOSE INJECTION",1,21,0.0196629213483146,104,5739,0.0476190476190476,0.0181216239763025,2.62774725274725,20,5635,0.848131282070756
"1277",973,"IP CTS ICU CARDIAC SURGERY POSTOP",13311,"101","ACETAMINOPHEN 325 MG PO TABS",32,1622,0.121854105626925,981,42092,0.0197287299630086,0.0233060914187969,0.846505302347563,1590,41111,0.392231905161933
"1278",973,"IP CTS ICU CARDIAC SURGERY POSTOP",13311,"102","ACETAMINOPHEN 500 MG PO TABS",5,123,0.00924047780031553,392,15968,0.040650406504065,0.0245490981963928,1.6558818649411,118,15576,0.392549316206799
"1279",973,"IP CTS ICU CARDIAC SURGERY POSTOP",13311,"680","ASPIRIN 81 MG PO CHEW",12,819,0.0615280594996619,357,11203,0.0146520146520147,0.031866464339909,0.459794174079888,807,10846,0.00799668365693572
"1280",973,"IP CTS ICU CARDIAC SURGERY POSTOP",13311,"693","ASPIRIN 300 MG PR SUPP",49,2018,0.151603936593795,70,1872,0.0242814667988107,0.0373931623931624,0.649355797819623,1969,1802,0.0226347793454293
"1281",973,"IP CTS ICU CARDIAC SURGERY POSTOP",13311,"1080","BISACODYL 10 MG PR SUPP",16,2623,0.197055067237623,344,22442,0.00609988562714449,0.0153284021031994,0.397946608268537,2607,22098,0.000240557734800305
"1282",973,"IP CTS ICU CARDIAC SURGERY POSTOP",13311,"2566","DOCUSATE SODIUM 100 MG PO CAPS",17,1859,0.139658928705582,542,37509,0.00914470145239376,0.0144498653656456,0.632857208077191,1842,36967,0.0739810295570757
"1283",973,"IP CTS ICU CARDIAC SURGERY POSTOP",13311,"2567","DOCUSATE SODIUM 250 MG PO CAPS",2,775,0.0582225227255653,296,17760,0.00258064516129032,0.0166666666666667,0.154838709677419,773,17464,0.00366045238524324
"1284",973,"IP CTS ICU CARDIAC SURGERY POSTOP",13311,"5002","METOCLOPRAMIDE HCL 5 MG/ML INJ SOLN",21,2580,0.193824656299301,346,10128,0.00813953488372093,0.0341627172195893,0.238257830353542,2559,9782,2.9417370589807e-12
"1285",973,"IP CTS ICU CARDIAC SURGERY POSTOP",13311,"5373","NALOXONE 0.4 MG/ML INJ SOLN",22,2551,0.191646007061829,83,1774,0.00862406899255194,0.0467869222096956,0.184326486660086,2529,1691,2.36898691524741e-15
"1286",973,"IP CTS ICU CARDIAC SURGERY POSTOP",13311,"9516","CHLORHEXIDINE GLUCONATE 0.12 % MM MWSH",17,1301,0.0977387123431748,89,4372,0.0130668716372022,0.0203568161024703,0.641891716829751,1284,4283,0.112268588003431
"1287",973,"IP CTS ICU CARDIAC SURGERY POSTOP",13311,"9627","CLINDAMYCIN IN DEXTROSE 5% 900 MG/50 ML IV PGBK",1,13,0.000976635865073999,29,474,0.0769230769230769,0.0611814345991561,1.25729442970822,12,445,0.999999999999975
"1288",973,"IP CTS ICU CARDIAC SURGERY POSTOP",13311,"10011","FAMOTIDINE 20 MG PO TABS",1,7,0.000525880850424461,472,16960,0.142857142857143,0.0278301886792453,5.13317191283293,6,16488,0.483877497244309
"1289",973,"IP CTS ICU CARDIAC SURGERY POSTOP",13311,"10055","FLUMAZENIL 0.1 MG/ML IV SOLN",24,2519,0.189241980317031,14,238,0.00952759031361651,0.0588235294117647,0.161969035331481,2495,224,2.77865094700502e-09
"1290",973,"IP CTS ICU CARDIAC SURGERY POSTOP",13311,"10813","OXYCODONE 5 MG/5 ML PO SOLN",2,34,0.00255427841634738,328,8370,0.0588235294117647,0.0391875746714456,1.50107604017217,32,8042,0.8839877519749
"1291",973,"IP CTS ICU CARDIAC SURGERY POSTOP",13311,"10814","OXYCODONE 5 MG PO TABS",85,5536,0.415896626849974,1478,56614,0.0153540462427746,0.0261066167379094,0.588128534498267,5451,55136,1.35368834644734e-06
"1292",973,"IP CTS ICU CARDIAC SURGERY POSTOP",13311,"11150","PROPOFOL 10 MG/ML IV EMUL",3,46,0.00345578844564646,135,3592,0.0652173913043478,0.0375835189309577,1.73526570048309,43,3457,0.557538341161427
"1293",973,"IP CTS ICU CARDIAC SURGERY POSTOP",13311,"11349","SENNOSIDES 8.6 MG PO TABS",23,2970,0.223123732251521,610,35793,0.00774410774410774,0.0170424384656218,0.454401390958768,2947,35183,0.000165450984146201
"1294",973,"IP CTS ICU CARDIAC SURGERY POSTOP",13311,"14863","POTASSIUM CHLORID-D5-0.45%NACL 20 MEQ/L IV SOLP",40,2457,0.184584178498986,314,8762,0.0162800162800163,0.035836566993837,0.454285040272301,2417,8448,1.32883014693635e-06
"1295",973,"IP CTS ICU CARDIAC SURGERY POSTOP",13311,"15859","NITROGLYCERIN IN 5 % DEXTROSE 50 MG/250 ML (200 MCG/ML) IV SOLN",67,1741,0.130794080084141,71,1104,0.038483630097645,0.0643115942028985,0.598393346870424,1674,1033,0.00240276325207342
"1296",973,"IP CTS ICU CARDIAC SURGERY POSTOP",13311,"25365","CEFAZOLIN IN DEXTROSE (ISO-OS) 1 GRAM/50 ML IV PGBK",37,1248,0.0937570430471039,258,5335,0.0296474358974359,0.0483598875351453,0.61305841284039,1211,5077,0.0051037351096309
"1297",973,"IP CTS ICU CARDIAC SURGERY POSTOP",13311,"25424","POLYETHYLENE GLYCOL 3350 17 GRAM PO PWPK",21,2908,0.218465930433476,712,36910,0.00722145804676754,0.0192901652668653,0.374359573744649,2887,36198,4.4384341492318e-06
"1298",973,"IP CTS ICU CARDIAC SURGERY POSTOP",13311,"34505","HYDROCODONE-ACETAMINOPHEN 5-325 MG PO TABS",1,8,0.000601006686199384,603,24164,0.125,0.0249544777354743,5.00912106135987,7,23561,0.496588042560405
"1299",973,"IP CTS ICU CARDIAC SURGERY POSTOP",13311,"81505","CIPROFLOXACIN IN D5W 400 MG/200 ML IV PGBK",1,7,0.000525880850424461,242,3682,0.142857142857143,0.0657251493753395,2.17355371900826,6,3440,0.952691421578972
"1300",973,"IP CTS ICU CARDIAC SURGERY POSTOP",13311,"82384","PANTOPRAZOLE 40 MG IV SOLR",125,2407,0.18082788671024,688,12925,0.0519318653926049,0.0532301740812379,0.975609535173573,2282,12237,0.832534463417621
"1301",973,"IP CTS ICU CARDIAC SURGERY POSTOP",13311,"83398","CLOPIDOGREL 75 MG PO TABS",2,44,0.00330553677409661,234,7279,0.0454545454545455,0.0321472729770573,1.41394716394716,42,7045,0.944025339048358
"1302",973,"IP CTS ICU CARDIAC SURGERY POSTOP",13311,"86533","MAGNESIUM HYDROXIDE 400 MG/5 ML PO SUSP",16,2549,0.191495755390279,111,6618,0.00627697136131816,0.0167724388032638,0.374243211434267,2533,6507,0.000175286331345698
"1303",973,"IP CTS ICU CARDIAC SURGERY POSTOP",13311,"88904","INSULIN REGULAR HUMAN 100 UNIT/ML INJ SOLN",30,1837,0.138006160318534,482,5722,0.0163309744148067,0.0842362810206222,0.19387102821893,1807,5240,1.20110293613179e-23
"1304",973,"IP CTS ICU CARDIAC SURGERY POSTOP",13311,"96559","PIPERACILLIN-TAZOBACTAM-DEXTRS 3.375 GRAM/50 ML IV PGBK",3,6,0.000450755014649538,1067,10067,0.5,0.105989867885169,4.7174320524836,3,9000,0.0135625029865434
"1305",973,"IP CTS ICU CARDIAC SURGERY POSTOP",13311,"110872","HYDROMORPHONE 2 MG/ML INJ SYRG",3,70,0.00525880850424461,738,23934,0.0428571428571429,0.0308347956881424,1.38989547038328,67,23196,0.814460674369173
"1306",973,"IP CTS ICU CARDIAC SURGERY POSTOP",13311,"112520","SODIUM CHLORIDE 0.9 % 0.9 % INJ SYRG",10,1432,0.10758019682969,11,154,0.00698324022346369,0.0714285714285714,0.0977653631284916,1422,143,3.4449746667665e-10
"1307",973,"IP CTS ICU CARDIAC SURGERY POSTOP",13311,"112586","HYDROMORPHONE 1 MG/ML INJ SYRG",1,39,0.002929907595222,1219,33427,0.0256410256410256,0.036467526251234,0.703119412717444,38,32208,0.999999999998899
"1308",973,"IP CTS ICU CARDIAC SURGERY POSTOP",13311,"124216","VANCOMYCIN IN D5W 1 GRAM/200 ML IV PGBK",34,688,0.051686575013147,1951,16917,0.0494186046511628,0.115327776792576,0.428505656014209,654,14966,1.18061264176275e-07
"1309",973,"IP CTS ICU CARDIAC SURGERY POSTOP",13311,"126992","LIDOCAINE (PF) 10 MG/ML (1 %) INJ SOLN",17,2606,0.195777928029449,457,11068,0.00652340752110514,0.0412902059992772,0.157989221977225,2589,10611,4.3456111785577e-18
"1310",973,"IP CTS ICU CARDIAC SURGERY POSTOP",13311,"198509","ONDANSETRON HCL (PF) 4 MG/2 ML INJ SOLN",17,2623,0.197055067237623,705,36939,0.00648112847884102,0.0190855193697718,0.339583553021147,2606,36234,4.54832457262351e-06
"1311",973,"IP CTS ICU CARDIAC SURGERY POSTOP",13311,"202606","FAMOTIDINE (PF) 20 MG/2 ML IV SOLN",7,155,0.0116445045451131,288,4280,0.0451612903225806,0.0672897196261682,0.671146953405018,148,3992,0.356504047063812
"1312",973,"IP CTS ICU CARDIAC SURGERY POSTOP",13311,"205192","MILRINONE IN D5W 20 MG/100 ML IV PGBK",8,237,0.0178048230786567,27,851,0.0337552742616034,0.0317273795534665,1.06391623691202,229,824,0.999999999999999
"1313",973,"IP CTS ICU CARDIAC SURGERY POSTOP",13311,"206169","DOPAMINE IN 5 % DEXTROSE 400 MG/250 ML (1,600 MCG/ML) IV SOLN",47,1105,0.0830140485312899,62,1778,0.0425339366515837,0.0348706411698538,1.21976353816961,1058,1716,0.342904769699969
"1314",973,"IP CTS ICU CARDIAC SURGERY POSTOP",13311,"206226","NICARDIPINE IN SALINE (ISO-OS) 40 MG/200 ML IV PGBK",3,71,0.00533393434001953,65,2286,0.0422535211267606,0.0284339457567804,1.48602383531961,68,2221,0.745069215117669
"1315",973,"IP CTS ICU CARDIAC SURGERY POSTOP",13311,"207694","NOREPINEPHRINE BITARTRATE-NACL 4 MG/250 ML (16 MCG/ML) IV SOLN",5,77,0.00578468935466907,56,1641,0.0649350649350649,0.0341255332114564,1.9028293135436,72,1585,0.265811710926495
"1316",973,"IP CTS ICU CARDIAC SURGERY POSTOP",13311,"212629","ACETAMINOPHEN 1,000 MG/100 ML (10 MG/ML) IV SOLN",29,1441,0.108256329351664,510,18335,0.0201249132546842,0.0278156531224434,0.723510361813011,1412,17825,0.10050527980017
"1317",973,"IP CTS ICU CARDIAC SURGERY POSTOP",13311,"212945","HEPARIN, PORCINE (PF) 5,000 UNIT/0.5 ML INJ SOLN",1,15,0.00112688753662384,452,13480,0.0666666666666667,0.0335311572700297,1.9882005899705,14,13028,0.999999999999989
"1318",973,"IP CTS ICU CARDIAC SURGERY POSTOP",13311,"221562","CALCIUM CHLORIDE 1 GRAM (13.6 MEQ)/50 ML NS IVPB",123,2541,0.190894748704079,156,2315,0.0484061393152302,0.0673866090712743,0.718334695607423,2418,2159,0.00548554382398013
"1319",973,"IP CTS ICU CARDIAC SURGERY POSTOP",13311,"226058","EPINEPHRINE HCL IN 0.9 % NACL 4 MG/250 ML (16 MCG/ML) IV SOLN",19,733,0.0550672376230186,56,1218,0.0259208731241473,0.0459770114942529,0.563778990450205,714,1162,0.0348611667639702
"1320",973,"IP CTS ICU CARDIAC SURGERY POSTOP",13311,"229762","DEXMEDETOMIDINE IN 0.9 % NACL 400 MCG/100 ML (4 MCG/ML) IV SOLN",49,1649,0.123882503192848,291,6612,0.0297149787750152,0.044010889292196,0.675173332166324,1600,6321,0.0109234061800515
"1321",973,"IP CTS ICU CARDIAC SURGERY POSTOP",13311,"236263","CEFAZOLIN IN DEXTROSE (ISO-OS) 2 GRAM/100 ML IV PGBK",60,778,0.0584479002328901,111,2584,0.077120822622108,0.0429566563467492,1.79531716806781,718,2473,0.000207898475084467
"1322",973,"IP CTS ICU CARDIAC SURGERY POSTOP",13311,"520064","CEFAZOLIN 2 G IVPB",1,126,0.0094658553076403,109,2674,0.00793650793650794,0.0407629020194465,0.194699286442406,125,2565,0.105470656041367
"1323",973,"IP CTS ICU CARDIAC SURGERY POSTOP",13311,"530001","AMIODARONE INFUSION PERIPH ADMIN",2,5,0.000375629178874615,7,168,0.4,0.0416666666666667,9.6,3,161,0.0112842138074326
"1324",973,"IP CTS ICU CARDIAC SURGERY POSTOP",13311,"530002","AMIODARONE INFUSION CENTRAL LINE ADMIN",1,48,0.0036060401171963,277,3542,0.0208333333333333,0.0782044042913608,0.266395908543923,47,3265,0.228089530283929
"1325",973,"IP CTS ICU CARDIAC SURGERY POSTOP",13311,"530006","EPINEPHRINE IV INFUSION",7,437,0.0328299902336414,99,2540,0.0160183066361556,0.0389763779527559,0.410974735917528,430,2441,0.0242876754439259
"1326",973,"IP CTS ICU CARDIAC SURGERY POSTOP",13311,"530008","NITROPRUSSIDE IV INFUSION",9,207,0.0155510480054091,79,2082,0.0434782608695652,0.0379442843419789,1.14584479911943,198,2003,0.837243978198321
"1327",973,"IP CTS ICU CARDIAC SURGERY POSTOP",13311,"530010","NICARDIPINE IV INFUSION",4,12,0.000901510029299076,257,676,0.333333333333333,0.380177514792899,0.876783398184176,8,419,0.974946567538517
"1328",973,"IP CTS ICU CARDIAC SURGERY POSTOP",13311,"530011","NOREPINEPHRINE IV INFUSION",1,24,0.00180302005859815,92,2909,0.0416666666666667,0.0316259883121348,1.31748188405797,23,2817,0.999999999999994
"1329",973,"IP CTS ICU CARDIAC SURGERY POSTOP",13311,"530025","DEXMEDETOMIDINE IV INFUSION",24,626,0.0470287731951018,530,2902,0.0383386581469649,0.18263266712612,0.209922237627343,602,2372,3.92581856325473e-19
"1330",973,"IP CTS ICU CARDIAC SURGERY POSTOP",13311,"530031","VASOPRESSIN 1 UNIT/ML IV INFUSION",4,117,0.00878972278566599,215,4489,0.0341880341880342,0.0478948540877701,0.713814351023653,113,4274,0.639951077356986
"1331",973,"IP CTS ICU CARDIAC SURGERY POSTOP",13311,"530039","AMINOCAPROIC ACID IV INFUSION",47,2109,0.158440387649313,10,148,0.0222854433380749,0.0675675675675676,0.329824561403509,2062,138,0.00179004920207259
"1332",973,"IP CTS ICU CARDIAC SURGERY POSTOP",13311,"540106","FENTANYL (PF) 50 MCG/ML INJECTION",59,2853,0.214334009465855,461,18637,0.0206799859796705,0.0247357407308043,0.836036656622819,2794,18176,0.212224289432385
"1333",973,"IP CTS ICU CARDIAC SURGERY POSTOP",13311,"540302","POTASSIUM CHLORIDE IV SCALE",19,2990,0.22462624896702,150,4660,0.00635451505016722,0.0321888412017167,0.197413600891862,2971,4510,1.15772106428612e-13
"1334",973,"IP CTS ICU CARDIAC SURGERY POSTOP",13311,"540304","MAGNESIUM SULFATE IV SCALE ",23,2617,0.196604312222973,78,4104,0.00878868933893772,0.0190058479532164,0.462420269833338,2594,4026,0.00113679391135
"1335",974,"IP CTS GEN ESOPHAGECTOMY POSTOP",440,"5002","METOCLOPRAMIDE HCL 5 MG/ML INJ SOLN",1,84,0.190909090909091,346,10128,0.0119047619047619,0.0341627172195893,0.348472336911643,83,9782,0.412809105013071
"1336",974,"IP CTS GEN ESOPHAGECTOMY POSTOP",440,"5373","NALOXONE 0.4 MG/ML INJ SOLN",1,3,0.00681818181818182,83,1774,0.333333333333333,0.0467869222096956,7.12449799196787,2,1691,0.329413318578587
"1337",974,"IP CTS GEN ESOPHAGECTOMY POSTOP",440,"27838","SODIUM CHLORIDE 0.9 % 0.9 % IV SOLP",1,1,0.00227272727272727,692,19620,1,0.0352701325178389,28.3526011560694,0,18928,0.0118194121841506
"1338",974,"IP CTS GEN ESOPHAGECTOMY POSTOP",440,"82384","PANTOPRAZOLE 40 MG IV SOLR",2,50,0.113636363636364,688,12925,0.04,0.0532301740812379,0.751453488372093,48,12237,0.920044840798298
"1339",974,"IP CTS GEN ESOPHAGECTOMY POSTOP",440,"198509","ONDANSETRON HCL (PF) 4 MG/2 ML INJ SOLN",1,85,0.193181818181818,705,36939,0.0117647058823529,0.0190855193697718,0.616420525657071,84,36234,0.923564261846866
"1340",974,"IP CTS GEN ESOPHAGECTOMY POSTOP",440,"212945","HEPARIN, PORCINE (PF) 5,000 UNIT/0.5 ML INJ SOLN",1,84,0.190909090909091,452,13480,0.0119047619047619,0.0335311572700297,0.35503581963759,83,13028,0.426511675816412
"1341",975,"IP CTS ESOPHAGECTOMY STEPDOWN POSTOP",176,"5002","METOCLOPRAMIDE HCL 5 MG/ML INJ SOLN",2,40,0.227272727272727,346,10128,0.05,0.0341627172195893,1.4635838150289,38,9782,0.909117038852275
"1342",975,"IP CTS ESOPHAGECTOMY STEPDOWN POSTOP",176,"5002","METOCLOPRAMIDE HCL 5 MG/ML INJ SOLN",2,40,0.227272727272727,346,10128,0.05,0.0341627172195893,1.4635838150289,38,9782,0.909117038852275
"1343",975,"IP CTS ESOPHAGECTOMY STEPDOWN POSTOP",176,"82384","PANTOPRAZOLE 40 MG IV SOLR",2,25,0.142045454545455,688,12925,0.08,0.0532301740812379,1.50290697674419,23,12237,0.880996607334719
"1344",975,"IP CTS ESOPHAGECTOMY STEPDOWN POSTOP",176,"82384","PANTOPRAZOLE 40 MG IV SOLR",2,25,0.142045454545455,688,12925,0.08,0.0532301740812379,1.50290697674419,23,12237,0.880996607334719
"1345",975,"IP CTS ESOPHAGECTOMY STEPDOWN POSTOP",176,"110872","HYDROMORPHONE 2 MG/ML INJ SYRG",2,14,0.0795454545454545,738,23934,0.142857142857143,0.0308347956881424,4.63298490127758,12,23196,0.0991457517564912
"1346",975,"IP CTS ESOPHAGECTOMY STEPDOWN POSTOP",176,"110872","HYDROMORPHONE 2 MG/ML INJ SYRG",2,14,0.0795454545454545,738,23934,0.142857142857143,0.0308347956881424,4.63298490127758,12,23196,0.0991457517564912
"1347",975,"IP CTS ESOPHAGECTOMY STEPDOWN POSTOP",176,"198509","ONDANSETRON HCL (PF) 4 MG/2 ML INJ SOLN",1,44,0.25,705,36939,0.0227272727272727,0.0190855193697718,1.19081237911025,43,36234,0.999999999997223
"1348",975,"IP CTS ESOPHAGECTOMY STEPDOWN POSTOP",176,"198509","ONDANSETRON HCL (PF) 4 MG/2 ML INJ SOLN",1,44,0.25,705,36939,0.0227272727272727,0.0190855193697718,1.19081237911025,43,36234,0.999999999997223
"1349",975,"IP CTS ESOPHAGECTOMY STEPDOWN POSTOP",176,"212945","HEPARIN, PORCINE (PF) 5,000 UNIT/0.5 ML INJ SOLN",2,37,0.210227272727273,452,13480,0.0540540540540541,0.0335311572700297,1.61205453240851,35,13028,0.814148147348766
"1350",975,"IP CTS ESOPHAGECTOMY STEPDOWN POSTOP",176,"212945","HEPARIN, PORCINE (PF) 5,000 UNIT/0.5 ML INJ SOLN",2,37,0.210227272727273,452,13480,0.0540540540540541,0.0335311572700297,1.61205453240851,35,13028,0.814148147348766
"1351",976,"IP CTS LUNG RESECTION POSTOP",4789,"101","ACETAMINOPHEN 325 MG PO TABS",5,423,0.0883274169972854,981,42092,0.0118203309692671,0.0233060914187969,0.507177748377566,418,41111,0.16171394476303
"1352",976,"IP CTS LUNG RESECTION POSTOP",4789,"102","ACETAMINOPHEN 500 MG PO TABS",2,97,0.0202547504698267,392,15968,0.0206185567010309,0.0245490981963928,0.839890595413423,95,15576,0.999999999999576
"1353",976,"IP CTS LUNG RESECTION POSTOP",4789,"1080","BISACODYL 10 MG PR SUPP",7,1069,0.223219878889121,344,22442,0.00654817586529467,0.0153284021031994,0.427192333630648,1062,22098,0.0289822980268318
"1354",976,"IP CTS LUNG RESECTION POSTOP",4789,"2475","DILTIAZEM HCL 30 MG PO TABS",3,277,0.0578408853622886,91,1786,0.0108303249097473,0.0509518477043673,0.212560003173722,274,1695,0.00473519852522684
"1355",976,"IP CTS LUNG RESECTION POSTOP",4789,"2509","DIPHENHYDRAMINE HCL 25 MG PO CAPS",3,952,0.198788891209021,356,12049,0.00315126050420168,0.0295460204166321,0.106656005098669,949,11693,2.84276472507585e-06
"1356",976,"IP CTS LUNG RESECTION POSTOP",4789,"2566","DOCUSATE SODIUM 100 MG PO CAPS",6,759,0.158488202129881,542,37509,0.00790513833992095,0.0144498653656456,0.547073494450359,753,36967,0.17758497572446
"1357",976,"IP CTS LUNG RESECTION POSTOP",4789,"2567","DOCUSATE SODIUM 250 MG PO CAPS",2,314,0.0655669242012946,296,17760,0.00636942675159236,0.0166666666666667,0.382165605095541,312,17464,0.231360025798157
"1358",976,"IP CTS LUNG RESECTION POSTOP",4789,"3843","IBUPROFEN 400 MG PO TABS",2,36,0.00751722697849238,148,4216,0.0555555555555556,0.0351043643263757,1.58258258258258,34,4068,0.834694435703878
"1359",976,"IP CTS LUNG RESECTION POSTOP",4789,"5002","METOCLOPRAMIDE HCL 5 MG/ML INJ SOLN",6,1044,0.217999582376279,346,10128,0.00574712643678161,0.0341627172195893,0.168228024715966,1038,9782,9.04613251104081e-07
"1360",976,"IP CTS LUNG RESECTION POSTOP",4789,"5007","METOPROLOL TARTRATE 5 MG/5 ML IV SOLN",1,65,0.013572770933389,745,12385,0.0153846153846154,0.0601534113847396,0.2557563242127,64,11640,0.209547464318446
"1361",976,"IP CTS LUNG RESECTION POSTOP",4789,"5940","OXYCODONE-ACETAMINOPHEN 5-325 MG PO TABS",11,492,0.102735435372729,218,7862,0.0223577235772358,0.0277283134062579,0.806313865890953,481,7644,0.571764072765455
"1362",976,"IP CTS LUNG RESECTION POSTOP",4789,"7753","TEMAZEPAM 15 MG PO CAPS",7,363,0.0757987053664648,24,941,0.0192837465564738,0.0255047821466525,0.756083562901745,356,917,0.64685174312441
"1363",976,"IP CTS LUNG RESECTION POSTOP",4789,"14858","D5-NS WITH POTASSIUM CHLORIDE 20 MEQ/L IV SOLP",10,969,0.202338692837753,58,2031,0.0103199174406605,0.0285573609059577,0.361375040034162,959,1973,0.00263651471266067
"1364",976,"IP CTS LUNG RESECTION POSTOP",4789,"22473","KETOROLAC 30 MG/ML (1 ML) INJ SOLN",3,122,0.0254750469826686,132,2852,0.0245901639344262,0.0462833099579243,0.531296572280179,119,2720,0.365397017248819
"1365",976,"IP CTS LUNG RESECTION POSTOP",4789,"25365","CEFAZOLIN IN DEXTROSE (ISO-OS) 1 GRAM/50 ML IV PGBK",17,822,0.171643349342243,258,5335,0.0206812652068127,0.0483598875351453,0.427653294102114,805,5077,0.000491491859621128
"1366",976,"IP CTS LUNG RESECTION POSTOP",4789,"27838","SODIUM CHLORIDE 0.9 % 0.9 % IV SOLP",2,29,0.00605554395489664,692,19620,0.0689655172413793,0.0352701325178389,1.95535180386685,27,18928,0.63198565991831
"1367",976,"IP CTS LUNG RESECTION POSTOP",4789,"37637","METOPROLOL TARTRATE 50 MG PO TABS",1,84,0.0175401962831489,809,19725,0.0119047619047619,0.0410139416983523,0.290261345576549,83,18916,0.28540608579144
"1368",976,"IP CTS LUNG RESECTION POSTOP",4789,"38390","ALUM-MAG HYDROXIDE-SIMETH 400-400-40 MG/5 ML PO SUSP",4,1017,0.21236166214241,14,882,0.00393313667649951,0.0158730158730159,0.247787610619469,1013,868,0.0146600291505708
"1369",976,"IP CTS LUNG RESECTION POSTOP",4789,"78668","IPRATROPIUM-ALBUTEROL 0.5 MG-3 MG(2.5 MG BASE)/3 ML INH NEBU",17,1096,0.22885779912299,493,18456,0.0155109489051095,0.0267121803207629,0.580669519254971,1079,17963,0.0305477242337149
"1370",976,"IP CTS LUNG RESECTION POSTOP",4789,"82384","PANTOPRAZOLE 40 MG IV SOLR",2,79,0.0164961369805805,688,12925,0.0253164556962025,0.0532301740812379,0.475603473653223,77,12237,0.394357133601174
"1371",976,"IP CTS LUNG RESECTION POSTOP",4789,"86533","MAGNESIUM HYDROXIDE 400 MG/5 ML PO SUSP",7,1027,0.214449780747546,111,6618,0.0068159688412853,0.0167724388032638,0.406379115239875,1020,6507,0.0230768581392515
"1372",976,"IP CTS LUNG RESECTION POSTOP",4789,"88043","PANTOPRAZOLE 40 MG PO TBEC",2,218,0.0455209855919816,624,31884,0.00917431192660551,0.0195709446744449,0.468772053634439,216,31260,0.389447593739177
"1373",976,"IP CTS LUNG RESECTION POSTOP",4789,"110872","HYDROMORPHONE 2 MG/ML INJ SYRG",1,148,0.0309041553560242,738,23934,0.00675675675675676,0.0308347956881424,0.219127664249615,147,23196,0.145904989988356
"1374",976,"IP CTS LUNG RESECTION POSTOP",4789,"110892","ENOXAPARIN 40 MG/0.4 ML SC SYRG",1,2,0.000417623721027354,499,13896,0.5,0.0359096142774899,13.9238476953908,1,13397,0.10408135842914
"1375",976,"IP CTS LUNG RESECTION POSTOP",4789,"112586","HYDROMORPHONE 1 MG/ML INJ SYRG",4,48,0.0100229693046565,1219,33427,0.0833333333333333,0.036467526251234,2.28513809133169,44,32208,0.178800482073504
"1376",976,"IP CTS LUNG RESECTION POSTOP",4789,"124216","VANCOMYCIN IN D5W 1 GRAM/200 ML IV PGBK",1,39,0.00814366256003341,1951,16917,0.0256410256410256,0.115327776792576,0.222331743090328,38,14966,0.13317668456428
"1377",976,"IP CTS LUNG RESECTION POSTOP",4789,"198509","ONDANSETRON HCL (PF) 4 MG/2 ML INJ SOLN",21,1168,0.243892253079975,705,36939,0.0179794520547945,0.0190855193697718,0.942046779364617,1147,36234,0.870090183148089
"1378",976,"IP CTS LUNG RESECTION POSTOP",4789,"202606","FAMOTIDINE (PF) 20 MG/2 ML IV SOLN",1,7,0.00146168302359574,288,4280,0.142857142857143,0.0672897196261682,2.12301587301587,6,3992,0.966175414383934
"1379",976,"IP CTS LUNG RESECTION POSTOP",4789,"212945","HEPARIN, PORCINE (PF) 5,000 UNIT/0.5 ML INJ SOLN",10,979,0.20442681144289,452,13480,0.0102145045965271,0.0335311572700297,0.304627260976073,969,13028,9.18464011025904e-05
"1380",976,"IP CTS LUNG RESECTION POSTOP",4789,"540640","IPRATROPIUM-ALBUTEROL 0.5MG-2.5MG BASE(3MG)/3ML INH NEB-PANEL USE ONLY",28,943,0.196909584464398,1,27,0.0296924708377519,0.037037037037037,0.8016967126193,915,26,0.999999999999999
"1381",978,"IP NSR ICU NEUROSURGERY POSTOPERATIVE",12217,"101","ACETAMINOPHEN 325 MG PO TABS",56,1999,0.163624457722845,981,42092,0.0280140070035018,0.0233060914187969,1.20200365218287,1943,41111,0.199989874335533
"1382",978,"IP NSR ICU NEUROSURGERY POSTOPERATIVE",12217,"105","ACETAMINOPHEN 650 MG PR SUPP",6,333,0.0272571007612343,59,929,0.018018018018018,0.0635091496232508,0.283707436249809,327,870,0.00208438406182113
"1383",978,"IP NSR ICU NEUROSURGERY POSTOPERATIVE",12217,"681","ASPIRIN 325 MG PO TABS",3,39,0.00319227306212655,303,7114,0.0769230769230769,0.0425920719707619,1.80604214267581,36,6811,0.509344002381142
"1384",978,"IP NSR ICU NEUROSURGERY POSTOPERATIVE",12217,"2327","DEXAMETHASONE 4 MG PO TABS",4,61,0.00499304248178767,277,6991,0.0655737704918033,0.0396223716206551,1.65496833757472,57,6714,0.482039979975244
"1385",978,"IP NSR ICU NEUROSURGERY POSTOPERATIVE",12217,"2332","DEXAMETHASONE SODIUM PHOSPHATE 4 MG/ML INJ SOLN",10,988,0.0808709175738725,390,6737,0.0101214574898785,0.0578892682202761,0.174841690023876,978,6347,4.07650912192305e-10
"1386",978,"IP NSR ICU NEUROSURGERY POSTOPERATIVE",12217,"2405","DIAZEPAM 5 MG PO TABS",4,225,0.018416959973807,152,5041,0.0177777777777778,0.0301527474707399,0.589590643274854,221,4889,0.384171282479482
"1387",978,"IP NSR ICU NEUROSURGERY POSTOPERATIVE",12217,"2566","DOCUSATE SODIUM 100 MG PO CAPS",27,1877,0.15363837275927,542,37509,0.0143846563665424,0.0144498653656456,0.99548722445136,1850,36967,0.999999999999982
"1388",978,"IP NSR ICU NEUROSURGERY POSTOPERATIVE",12217,"2567","DOCUSATE SODIUM 250 MG PO CAPS",13,877,0.0717852173201277,296,17760,0.0148232611174458,0.0166666666666667,0.88939566704675,864,17464,0.778024636203177
"1389",978,"IP NSR ICU NEUROSURGERY POSTOPERATIVE",12217,"3697","HYDRALAZINE 20 MG/ML INJ SOLN",15,1889,0.15462061062454,537,15149,0.00794070937003706,0.0354478843488019,0.224010812377451,1874,14612,3.01294715172823e-10
"1390",978,"IP NSR ICU NEUROSURGERY POSTOPERATIVE",12217,"4711","MAGNESIUM CITRATE PO SOLN",2,362,0.0296308422689695,131,5481,0.00552486187845304,0.0239007480386791,0.231158534013749,360,5350,0.0367531724299289
"1391",978,"IP NSR ICU NEUROSURGERY POSTOPERATIVE",12217,"5002","METOCLOPRAMIDE HCL 5 MG/ML INJ SOLN",23,2690,0.220184988131292,346,10128,0.00855018587360595,0.0341627172195893,0.250278273201968,2667,9782,2.61469240733343e-12
"1392",978,"IP NSR ICU NEUROSURGERY POSTOPERATIVE",12217,"5007","METOPROLOL TARTRATE 5 MG/5 ML IV SOLN",14,1626,0.133093230744045,745,12385,0.00861008610086101,0.0601534113847396,0.14313545820022,1612,11640,9.94532030676625e-18
"1393",978,"IP NSR ICU NEUROSURGERY POSTOPERATIVE",12217,"5373","NALOXONE 0.4 MG/ML INJ SOLN",24,2774,0.22706065318818,83,1774,0.00865176640230714,0.0467869222096956,0.184918477080637,2750,1691,2.93512580703755e-16
"1394",978,"IP NSR ICU NEUROSURGERY POSTOPERATIVE",12217,"8958","BUTALBITAL-ACETAMINOPHEN-CAFF 50-325-40 MG PO TABS",1,193,0.0157976589997544,58,2595,0.00518134715025907,0.0223506743737958,0.231820618188315,192,2537,0.180345201898584
"1395",978,"IP NSR ICU NEUROSURGERY POSTOPERATIVE",12217,"9627","CLINDAMYCIN IN DEXTROSE 5% 900 MG/50 ML IV PGBK",1,5,0.000409265777195711,29,474,0.2,0.0611814345991561,3.26896551724138,4,445,0.728829318099584
"1396",978,"IP NSR ICU NEUROSURGERY POSTOPERATIVE",12217,"10011","FAMOTIDINE 20 MG PO TABS",1,51,0.00417451092739625,472,16960,0.0196078431372549,0.0278301886792453,0.704553007643735,50,16488,0.999999999999115
"1397",978,"IP NSR ICU NEUROSURGERY POSTOPERATIVE",12217,"10055","FLUMAZENIL 0.1 MG/ML IV SOLN",20,2749,0.225014324302202,14,238,0.00727537286285922,0.0588235294117647,0.123681338668607,2729,224,6.27385096849317e-12
"1398",978,"IP NSR ICU NEUROSURGERY POSTOPERATIVE",12217,"10610","MIDODRINE 5 MG PO TABS",1,24,0.00196447573053941,154,4184,0.0416666666666667,0.0368068833652008,1.13203463203463,23,4030,0.999999999999999
"1399",978,"IP NSR ICU NEUROSURGERY POSTOPERATIVE",12217,"10814","OXYCODONE 5 MG PO TABS",1,92,0.00753049030040108,1478,56614,0.0108695652173913,0.0261066167379094,0.416352885803377,91,55136,0.555924614567641
"1400",978,"IP NSR ICU NEUROSURGERY POSTOPERATIVE",12217,"11150","PROPOFOL 10 MG/ML IV EMUL",3,53,0.00433821723827454,135,3592,0.0566037735849057,0.0375835189309577,1.50607966457023,50,3457,0.720551346961699
"1401",978,"IP NSR ICU NEUROSURGERY POSTOPERATIVE",12217,"11349","SENNOSIDES 8.6 MG PO TABS",34,3031,0.24809691413604,610,35793,0.0112174199934015,0.0170424384656218,0.658205104629214,2997,35183,0.0194475428003885
"1402",978,"IP NSR ICU NEUROSURGERY POSTOPERATIVE",12217,"16426","NS WITH POTASSIUM CHLORIDE 20 MEQ/L IV SOLP",23,2489,0.203732503888025,118,4415,0.00924065889915629,0.026727066817667,0.345741602031992,2466,4297,1.27446820673438e-06
"1403",978,"IP NSR ICU NEUROSURGERY POSTOPERATIVE",12217,"25365","CEFAZOLIN IN DEXTROSE (ISO-OS) 1 GRAM/50 ML IV PGBK",8,110,0.00900384709830564,258,5335,0.0727272727272727,0.0483598875351453,1.50387596899225,102,5077,0.342042452877117
"1404",978,"IP NSR ICU NEUROSURGERY POSTOPERATIVE",12217,"25424","POLYETHYLENE GLYCOL 3350 17 GRAM PO PWPK",8,854,0.0699025947450274,712,36910,0.00936768149882904,0.0192901652668653,0.485619556350814,846,36198,0.0488770989170476
"1405",978,"IP NSR ICU NEUROSURGERY POSTOPERATIVE",12217,"28384","HYDROCODONE-ACETAMINOPHEN 10-325 MG PO TABS",9,294,0.0240648276991078,335,9576,0.0306122448979592,0.0349832915622389,0.875053304904051,285,9241,0.809482976585641
"1406",978,"IP NSR ICU NEUROSURGERY POSTOPERATIVE",12217,"34505","HYDROCODONE-ACETAMINOPHEN 5-325 MG PO TABS",27,2440,0.199721699271507,603,24164,0.0110655737704918,0.0249544777354743,0.443430389038414,2413,23561,2.33406648689411e-05
"1407",978,"IP NSR ICU NEUROSURGERY POSTOPERATIVE",12217,"81421","ESMOLOL IN NACL (ISO-OSM) 2,500 MG/250 ML (10 MG/ML) IV SOLP",29,2172,0.177785053613817,72,1479,0.0133517495395948,0.0486815415821501,0.274267188459177,2143,1407,3.23647654593304e-10
"1408",978,"IP NSR ICU NEUROSURGERY POSTOPERATIVE",12217,"81934","NIMODIPINE 30 MG PO CAPS",11,228,0.0186625194401244,23,372,0.0482456140350877,0.0618279569892473,0.780320366132723,217,349,0.605456801089997
"1409",978,"IP NSR ICU NEUROSURGERY POSTOPERATIVE",12217,"82384","PANTOPRAZOLE 40 MG IV SOLR",6,118,0.00965867234181878,688,12925,0.0508474576271186,0.0532301740812379,0.955237485218762,112,12237,0.999999999999903
"1410",978,"IP NSR ICU NEUROSURGERY POSTOPERATIVE",12217,"86533","MAGNESIUM HYDROXIDE 400 MG/5 ML PO SUSP",3,355,0.0290578701808955,111,6618,0.00845070422535211,0.0167724388032638,0.503844689760183,352,6507,0.322306189945883
"1411",978,"IP NSR ICU NEUROSURGERY POSTOPERATIVE",12217,"88043","PANTOPRAZOLE 40 MG PO TBEC",1,50,0.00409265777195711,624,31884,0.02,0.0195709446744449,1.02192307692308,49,31260,0.999999999999959
"1412",978,"IP NSR ICU NEUROSURGERY POSTOPERATIVE",12217,"93305","SCOPOLAMINE BASE 1.5 MG (1 MG OVER 3 DAYS) TD PT3D",15,915,0.0748956372268151,93,5289,0.0163934426229508,0.0175836642087351,0.932310946589106,900,5196,0.906630634939426
"1413",978,"IP NSR ICU NEUROSURGERY POSTOPERATIVE",12217,"110892","ENOXAPARIN 40 MG/0.4 ML SC SYRG",1,26,0.0021281820414177,499,13896,0.0384615384615385,0.0359096142774899,1.07106520733775,25,13397,0.999999999999289
"1414",978,"IP NSR ICU NEUROSURGERY POSTOPERATIVE",12217,"112586","HYDROMORPHONE 1 MG/ML INJ SYRG",3,73,0.00597528034705738,1219,33427,0.0410958904109589,0.036467526251234,1.1269174149033,70,32208,0.999999999999863
"1415",978,"IP NSR ICU NEUROSURGERY POSTOPERATIVE",12217,"117862","HYDROCODONE-ACETAMINOPHEN 7.5-325 MG/15 ML PO SOLN",2,9,0.00073667839895228,79,3308,0.222222222222222,0.0238814993954051,9.30520393811533,7,3229,0.00563055500863467
"1416",978,"IP NSR ICU NEUROSURGERY POSTOPERATIVE",12217,"124216","VANCOMYCIN IN D5W 1 GRAM/200 ML IV PGBK",4,64,0.0052386019481051,1951,16917,0.0625,0.115327776792576,0.541933623782676,60,14966,0.260412994910942
"1417",978,"IP NSR ICU NEUROSURGERY POSTOPERATIVE",12217,"124873","SENNA LEAF EXTRACT 176 MG/5 ML PO SYRP",3,147,0.0120324138495539,90,4112,0.0204081632653061,0.0218871595330739,0.932426303854875,144,4022,0.999999999999917
"1418",978,"IP NSR ICU NEUROSURGERY POSTOPERATIVE",12217,"126992","LIDOCAINE (PF) 10 MG/ML (1 %) INJ SOLN",6,1805,0.147744945567652,457,11068,0.00332409972299169,0.0412902059992772,0.0805057674706171,1799,10611,1.66557892726479e-15
"1419",978,"IP NSR ICU NEUROSURGERY POSTOPERATIVE",12217,"198509","ONDANSETRON HCL (PF) 4 MG/2 ML INJ SOLN",46,2906,0.237865269706147,705,36939,0.0158293186510668,0.0190855193697718,0.829388938513128,2860,36234,0.241198248154265
"1420",978,"IP NSR ICU NEUROSURGERY POSTOPERATIVE",12217,"202606","FAMOTIDINE (PF) 20 MG/2 ML IV SOLN",248,2311,0.189162642219858,288,4280,0.107312851579403,0.0672897196261682,1.59478821097168,2063,3992,1.8528398080245e-08
"1421",978,"IP NSR ICU NEUROSURGERY POSTOPERATIVE",12217,"206226","NICARDIPINE IN SALINE (ISO-OS) 40 MG/200 ML IV PGBK",6,717,0.0586887124498649,65,2286,0.00836820083682008,0.0284339457567804,0.294303186353396,711,2221,0.00323377842553168
"1422",978,"IP NSR ICU NEUROSURGERY POSTOPERATIVE",12217,"209037","ACETAMINOPHEN 650 MG/20.3 ML PO SOLN",3,75,0.00613898665793566,192,8611,0.04,0.0222970618975729,1.79395833333333,72,8419,0.522821843481971
"1423",978,"IP NSR ICU NEUROSURGERY POSTOPERATIVE",12217,"210741","PHENYLEPHRINE IN 0.9% NACL(PF) 40 MG/250 ML (160 MCG/ML) IV SOLN",1,203,0.0166161905541459,43,1494,0.00492610837438424,0.0287817938420348,0.171153625844885,202,1451,0.076493453137841
"1424",978,"IP NSR ICU NEUROSURGERY POSTOPERATIVE",12217,"211084","CALCIUM GLUCONATE IN 0.9% NACL 1 GRAM/50 ML IV SOLN",6,2110,0.17271015797659,326,12268,0.0028436018957346,0.0265731985653733,0.107010147413718,2104,11942,3.46401588149896e-11
"1425",978,"IP NSR ICU NEUROSURGERY POSTOPERATIVE",12217,"212629","ACETAMINOPHEN 1,000 MG/100 ML (10 MG/ML) IV SOLN",9,796,0.0651551117295572,510,18335,0.0113065326633166,0.0278156531224434,0.406480934082176,787,17825,0.00703129546987584
"1426",978,"IP NSR ICU NEUROSURGERY POSTOPERATIVE",12217,"212945","HEPARIN, PORCINE (PF) 5,000 UNIT/0.5 ML INJ SOLN",1,22,0.00180076941966113,452,13480,0.0454545454545455,0.0335311572700297,1.35559131134352,21,13028,0.999999999999979
"1427",978,"IP NSR ICU NEUROSURGERY POSTOPERATIVE",12217,"221562","CALCIUM CHLORIDE 1 GRAM (13.6 MEQ)/50 ML NS IVPB",179,1189,0.0973234018171401,156,2315,0.150546677880572,0.0673866090712743,2.23407409803541,1010,2159,3.66744470065855e-15
"1428",978,"IP NSR ICU NEUROSURGERY POSTOPERATIVE",12217,"222567","LEVETIRACETAM IN NACL (ISO-OS) 500 MG/100 ML IV PGBK",3,63,0.00515674879266596,50,1098,0.0476190476190476,0.0455373406193078,1.04571428571429,60,1048,0.999999999999986
"1429",978,"IP NSR ICU NEUROSURGERY POSTOPERATIVE",12217,"229762","DEXMEDETOMIDINE IN 0.9 % NACL 400 MCG/100 ML (4 MCG/ML) IV SOLN",2,53,0.00433821723827454,291,6612,0.0377358490566038,0.044010889292196,0.857420735265513,51,6321,0.99999999999985
"1430",978,"IP NSR ICU NEUROSURGERY POSTOPERATIVE",12217,"230362","NIMODIPINE 60 MG/20 ML PO SOLN",1,43,0.00351968568388311,12,316,0.0232558139534884,0.0379746835443038,0.612403100775194,42,304,0.960374476934782
"1431",978,"IP NSR ICU NEUROSURGERY POSTOPERATIVE",12217,"236263","CEFAZOLIN IN DEXTROSE (ISO-OS) 2 GRAM/100 ML IV PGBK",1,29,0.00237374150773512,111,2584,0.0344827586206897,0.0429566563467492,0.80273376825101,28,2473,0.999999999999865
"1432",978,"IP NSR ICU NEUROSURGERY POSTOPERATIVE",12217,"520064","CEFAZOLIN 2 G IVPB",2,27,0.00221003519685684,109,2674,0.0740740740740741,0.0407629020194465,1.81719334012912,25,2565,0.703652146706697
"1433",978,"IP NSR ICU NEUROSURGERY POSTOPERATIVE",12217,"520068","PHENYTOIN IVPB (500 MG OR LESS)",4,14,0.00114594417614799,153,533,0.285714285714286,0.287054409005629,0.995331465919701,10,380,0.999999999999993
"1434",978,"IP NSR ICU NEUROSURGERY POSTOPERATIVE",12217,"520301","CEFTRIAXONE 1 GRAM/50 ML NS IVPB",22,1388,0.113612179749529,3,146,0.015850144092219,0.0205479452054795,0.771373679154659,1366,143,0.933954713653156
"1435",978,"IP NSR ICU NEUROSURGERY POSTOPERATIVE",12217,"530008","NITROPRUSSIDE IV INFUSION",36,1685,0.137922566914955,79,2082,0.0213649851632047,0.0379442843419789,0.563062014048004,1649,2003,0.00443099950431445
"1436",978,"IP NSR ICU NEUROSURGERY POSTOPERATIVE",12217,"530010","NICARDIPINE IV INFUSION",14,45,0.0036833919947614,257,676,0.311111111111111,0.380177514792899,0.818331171638565,31,419,0.442896914856134
"1437",978,"IP NSR ICU NEUROSURGERY POSTOPERATIVE",12217,"530011","NOREPINEPHRINE IV INFUSION",1,13,0.00106409102070885,92,2909,0.0769230769230769,0.0316259883121348,2.43227424749164,12,2817,0.89137470465442
"1438",978,"IP NSR ICU NEUROSURGERY POSTOPERATIVE",12217,"530012","PHENYLEPHRINE IV INFUSION",1,75,0.00613898665793566,61,2180,0.0133333333333333,0.0279816513761468,0.476502732240437,74,2119,0.686441233729763
"1439",978,"IP NSR ICU NEUROSURGERY POSTOPERATIVE",12217,"530025","DEXMEDETOMIDINE IV INFUSION",1,6,0.000491118932634853,530,2902,0.166666666666667,0.18263266712612,0.912578616352201,5,2372,0.999999999999906
"1440",978,"IP NSR ICU NEUROSURGERY POSTOPERATIVE",12217,"540106","FENTANYL (PF) 50 MCG/ML INJECTION",44,3100,0.253744781861341,461,18637,0.0141935483870968,0.0247357407308043,0.573807291302218,3056,18176,0.000394776050842226
"1441",978,"IP NSR ICU NEUROSURGERY POSTOPERATIVE",12217,"540301","POTASSIUM CHLORIDE ORAL SCALE",5,1212,0.0992060243922403,105,3653,0.00412541254125413,0.0287434984943882,0.143525066792394,1207,3548,1.03822160800388e-06
"1442",978,"IP NSR ICU NEUROSURGERY POSTOPERATIVE",12217,"540302","POTASSIUM CHLORIDE IV SCALE",6,1585,0.12973725137104,150,4660,0.00378548895899054,0.0321888412017167,0.117602523659306,1579,4510,7.00893255161969e-10
"1443",978,"IP NSR ICU NEUROSURGERY POSTOPERATIVE",12217,"540304","MAGNESIUM SULFATE IV SCALE ",6,2137,0.174920193173447,78,4104,0.00280767430978007,0.0190058479532164,0.147726863683813,2131,4026,2.55238263847669e-07
"1444",978,"IP NSR ICU NEUROSURGERY POSTOPERATIVE",12217,"541524","CEFAZOLIN IN NS IVPB (COMPOUNDED)",10,330,0.0270115412949169,1,61,0.0303030303030303,0.0163934426229508,1.84848484848485,320,60,0.855463074100031
"1445",980,"IP TRS LUNG, HEART-LUNG TRANSPLANT PREOP",309,"9626","CLINDAMYCIN IN 5 % DEXTROSE 600 MG/50 ML IV PGBK",1,6,0.0194174757281553,70,1432,0.166666666666667,0.0488826815642458,3.40952380952381,5,1362,0.700417481270438
"1446",980,"IP TRS LUNG, HEART-LUNG TRANSPLANT PREOP",309,"25365","CEFAZOLIN IN DEXTROSE (ISO-OS) 1 GRAM/50 ML IV PGBK",1,25,0.0809061488673139,258,5335,0.04,0.0483598875351453,0.827131782945737,24,5077,0.999999999999747
"1447",980,"IP TRS LUNG, HEART-LUNG TRANSPLANT PREOP",309,"27838","SODIUM CHLORIDE 0.9 % 0.9 % IV SOLP",2,54,0.174757281553398,692,19620,0.037037037037037,0.0352701325178389,1.05009633911368,52,18928,0.999999999999991
"1448",980,"IP TRS LUNG, HEART-LUNG TRANSPLANT PREOP",309,"96559","PIPERACILLIN-TAZOBACTAM-DEXTRS 3.375 GRAM/50 ML IV PGBK",2,58,0.187702265372168,1067,10067,0.0344827586206897,0.105989867885169,0.325340141550593,56,9000,0.12046861892082
"1449",980,"IP TRS LUNG, HEART-LUNG TRANSPLANT PREOP",309,"110888","ENOXAPARIN 30 MG/0.3 ML SC SYRG",1,1,0.00323624595469256,73,1394,1,0.0523672883787661,19.0958904109589,0,1321,0.0460518955900975
"1450",980,"IP TRS LUNG, HEART-LUNG TRANSPLANT PREOP",309,"124216","VANCOMYCIN IN D5W 1 GRAM/200 ML IV PGBK",4,117,0.378640776699029,1951,16917,0.0341880341880342,0.115327776792576,0.296442324120438,113,14966,0.00936334181490198
"1451",981,"IP TRS LUNG, HEART-LUNG TRANSPLANT POSTOP",693,"464","AMPHOTERICIN B 50 MG INJ SOLR",1,38,0.0548340548340548,4,131,0.0263157894736842,0.0305343511450382,0.861842105263158,37,127,0.999999999999998
"1452",981,"IP TRS LUNG, HEART-LUNG TRANSPLANT POSTOP",693,"2365","DEXTROSE 50 % IN WATER (D50W) IV SYRG",5,98,0.141414141414141,134,3551,0.0510204081632653,0.0377358490566038,1.35204081632653,93,3417,0.681612643367292
"1453",981,"IP TRS LUNG, HEART-LUNG TRANSPLANT POSTOP",693,"5751","NYSTATIN 100,000 UNIT/ML PO SUSP",1,10,0.0144300144300144,68,4056,0.1,0.0167652859960552,5.96470588235294,9,3988,0.418118011459487
"1454",981,"IP TRS LUNG, HEART-LUNG TRANSPLANT POSTOP",693,"6492","PREDNISONE 5 MG/5 ML PO SOLN",1,1,0.00144300144300144,72,1096,1,0.0656934306569343,15.2222222222222,0,1024,0.0818675297324781
"1455",981,"IP TRS LUNG, HEART-LUNG TRANSPLANT POSTOP",693,"7555","SULFAMETHOXAZOLE-TRIMETHOPRIM 800-160 MG PO TABS",1,9,0.012987012987013,273,6399,0.111111111111111,0.0426629160806376,2.6043956043956,8,6126,0.849398398069859
"1456",981,"IP TRS LUNG, HEART-LUNG TRANSPLANT POSTOP",693,"9644","CLOTRIMAZOLE 10 MG MM TROC",1,12,0.0173160173160173,29,2750,0.0833333333333333,0.0105454545454545,7.90229885057471,11,2721,0.302183507116337
"1457",981,"IP TRS LUNG, HEART-LUNG TRANSPLANT POSTOP",693,"10607","MIDAZOLAM 1 MG/ML INJ SOLN",1,2,0.00288600288600289,155,5616,0.5,0.0275997150997151,18.1161290322581,1,5461,0.0557324080954827
"1458",981,"IP TRS LUNG, HEART-LUNG TRANSPLANT POSTOP",693,"27838","SODIUM CHLORIDE 0.9 % 0.9 % IV SOLP",2,6,0.00865800865800866,692,19620,0.333333333333333,0.0352701325178389,9.45086705202312,4,18928,0.0044118382989373
"1459",981,"IP TRS LUNG, HEART-LUNG TRANSPLANT POSTOP",693,"82544","ITRACONAZOLE 10 MG/ML PO SOLN",3,14,0.0202020202020202,27,1462,0.214285714285714,0.0184678522571819,11.6031746031746,11,1435,2.48589772422308e-05
"1460",981,"IP TRS LUNG, HEART-LUNG TRANSPLANT POSTOP",693,"96559","PIPERACILLIN-TAZOBACTAM-DEXTRS 3.375 GRAM/50 ML IV PGBK",1,2,0.00288600288600289,1067,10067,0.5,0.105989867885169,4.7174320524836,1,9000,0.508544984834858
"1461",981,"IP TRS LUNG, HEART-LUNG TRANSPLANT POSTOP",693,"124216","VANCOMYCIN IN D5W 1 GRAM/200 ML IV PGBK",10,104,0.15007215007215,1951,16917,0.0961538461538462,0.115327776792576,0.833744036588732,94,14966,0.648009707065288
"1462",981,"IP TRS LUNG, HEART-LUNG TRANSPLANT POSTOP",693,"198509","ONDANSETRON HCL (PF) 4 MG/2 ML INJ SOLN",5,105,0.151515151515152,705,36939,0.0476190476190476,0.0190855193697718,2.49503546099291,100,36234,0.0762198324783069
"1463",981,"IP TRS LUNG, HEART-LUNG TRANSPLANT POSTOP",693,"209037","ACETAMINOPHEN 650 MG/20.3 ML PO SOLN",9,110,0.158730158730159,192,8611,0.0818181818181818,0.0222970618975729,3.66946022727273,101,8419,0.000136641588029632
"1464",981,"IP TRS LUNG, HEART-LUNG TRANSPLANT POSTOP",693,"209509","METHYLPREDNISOLONE SOD SUC(PF) 125 MG/2 ML INJ SOLR",6,97,0.13997113997114,275,8000,0.0618556701030928,0.034375,1.79943767572634,91,7725,0.233729188766881
"1465",981,"IP TRS LUNG, HEART-LUNG TRANSPLANT POSTOP",693,"212945","HEPARIN, PORCINE (PF) 5,000 UNIT/0.5 ML INJ SOLN",1,6,0.00865800865800866,452,13480,0.166666666666667,0.0335311572700297,4.97050147492625,5,13028,0.498774860641588
"1466",981,"IP TRS LUNG, HEART-LUNG TRANSPLANT POSTOP",693,"229762","DEXMEDETOMIDINE IN 0.9 % NACL 400 MCG/100 ML (4 MCG/ML) IV SOLN",1,38,0.0548340548340548,291,6612,0.0263157894736842,0.044010889292196,0.597938144329897,37,6321,0.893524076248935
"1467",981,"IP TRS LUNG, HEART-LUNG TRANSPLANT POSTOP",693,"520055","GANCICLOVIR IVPB",4,105,0.151515151515152,62,1312,0.0380952380952381,0.0472560975609756,0.806144393241167,101,1250,0.850882253038808
"1468",981,"IP TRS LUNG, HEART-LUNG TRANSPLANT POSTOP",693,"530006","EPINEPHRINE IV INFUSION",1,35,0.0505050505050505,99,2540,0.0285714285714286,0.0389763779527559,0.733044733044733,34,2441,0.999999999999966
"1469",981,"IP TRS LUNG, HEART-LUNG TRANSPLANT POSTOP",693,"530025","DEXMEDETOMIDINE IV INFUSION",1,12,0.0173160173160173,530,2902,0.0833333333333333,0.18263266712612,0.456289308176101,11,2372,0.606854534700818
"1470",981,"IP TRS LUNG, HEART-LUNG TRANSPLANT POSTOP",693,"530031","VASOPRESSIN 1 UNIT/ML IV INFUSION",2,14,0.0202020202020202,215,4489,0.142857142857143,0.0478948540877701,2.98272425249169,12,4274,0.302282910915641
"1471",981,"IP TRS LUNG, HEART-LUNG TRANSPLANT POSTOP",693,"530049","INSULIN REGULAR 1 UNIT/ML IV INFUSION (NEW)",4,88,0.126984126984127,23,2672,0.0454545454545455,0.00860778443113772,5.28063241106719,84,2649,0.00367119062010235
"1472",981,"IP TRS LUNG, HEART-LUNG TRANSPLANT POSTOP",693,"540129","TACROLIMUS 1 MG/ML ORAL SUSPENSION",2,17,0.0245310245310245,147,4881,0.117647058823529,0.0301167793484942,3.90636254501801,15,4734,0.164404887473504
"1473",981,"IP TRS LUNG, HEART-LUNG TRANSPLANT POSTOP",693,"540302","POTASSIUM CHLORIDE IV SCALE",2,45,0.0649350649350649,150,4660,0.0444444444444444,0.0321888412017167,1.38074074074074,43,4510,0.968760915256859
"1474",981,"IP TRS LUNG, HEART-LUNG TRANSPLANT POSTOP",693,"540304","MAGNESIUM SULFATE IV SCALE ",3,43,0.062049062049062,78,4104,0.0697674418604651,0.0190058479532164,3.67084078711986,40,4026,0.0659191769968006
"1475",981,"IP TRS LUNG, HEART-LUNG TRANSPLANT POSTOP",693,"540321","MYCOPHENOLATE MOFETIL 200 MG/ML ORAL SUSP",4,88,0.126984126984127,49,786,0.0454545454545455,0.0623409669211196,0.7291280148423,84,737,0.693638135329594
"1476",981,"IP TRS LUNG, HEART-LUNG TRANSPLANT POSTOP",693,"540492","SHC TRANSPLANT BEDSIDE MEDS HELP ORDER",1,9,0.012987012987013,3,27,0.111111111111111,0.111111111111111,1,8,24,1
"1477",981,"IP TRS LUNG, HEART-LUNG TRANSPLANT POSTOP",693,"541098","CEFEPIME 1 GRAM/50 ML MINI-BAG PLUS",9,55,0.0793650793650794,199,1387,0.163636363636364,0.143475126171593,1.14052078574692,46,1188,0.824535439194576
"1478",981,"IP TRS LUNG, HEART-LUNG TRANSPLANT POSTOP",693,"541271","PIPERACILLIN-TAZOBACTAM 3.375 GRAM/50 ML IVPB EXTENDED INFUSION",3,5,0.00721500721500722,466,8270,0.6,0.0563482466747279,10.6480686695279,2,7804,1.79894491474564e-05
"1479",981,"IP TRS LUNG, HEART-LUNG TRANSPLANT POSTOP",693,"541285","AMPHOTERICIN B 20 MG/4ML NEB SOLUTION",3,50,0.0721500721500721,2,126,0.06,0.0158730158730159,3.78,47,124,0.277449367755867
"1480",981,"IP TRS LUNG, HEART-LUNG TRANSPLANT POSTOP",693,"541543","CEFEPIME 1 G/50 ML EXTENDED INFUSION MINI-BAG PLUS",6,17,0.0245310245310245,39,371,0.352941176470588,0.105121293800539,3.35746606334842,11,332,0.006274241137796
"1481",982,"IP TRS HEART TRANSPLANT PREOP",441,"25365","CEFAZOLIN IN DEXTROSE (ISO-OS) 1 GRAM/50 ML IV PGBK",2,39,0.0884353741496599,258,5335,0.0512820512820513,0.0483598875351453,1.06042536275094,37,5077,0.999999999999991
"1482",982,"IP TRS HEART TRANSPLANT PREOP",441,"96559","PIPERACILLIN-TAZOBACTAM-DEXTRS 3.375 GRAM/50 ML IV PGBK",5,112,0.253968253968254,1067,10067,0.0446428571428571,0.105989867885169,0.421199290400321,107,9000,0.0513406024347579
"1483",982,"IP TRS HEART TRANSPLANT PREOP",441,"124216","VANCOMYCIN IN D5W 1 GRAM/200 ML IV PGBK",6,170,0.385487528344671,1951,16917,0.0352941176470588,0.115327776792576,0.306033105194923,164,14966,0.00169281603350242
"1484",982,"IP TRS HEART TRANSPLANT PREOP",441,"540965","PIPERACILLIN-TAZOBACTAM 3.375 GRAM/50 ML MINI-BAG PLUS",1,16,0.036281179138322,235,4195,0.0625,0.0560190703218117,1.1156914893617,15,3960,0.99999999999999
"1485",1049,"IP/ED GENERAL TRANSFUSION",52260,"101","ACETAMINOPHEN 325 MG PO TABS",16,1345,0.0257367011098354,981,42092,0.0118959107806691,0.0233060914187969,0.51042066929656,1329,41111,0.00785482005932001
"1486",1049,"IP/ED GENERAL TRANSFUSION",52260,"2509","DIPHENHYDRAMINE HCL 25 MG PO CAPS",23,1270,0.0243015690776885,356,12049,0.0181102362204724,0.0295460204166321,0.6129501017429,1247,11693,0.0249258068818054
"1487",1049,"IP/ED GENERAL TRANSFUSION",52260,"3291","FUROSEMIDE 10 MG/ML INJ SOLN",19,600,0.0114810562571757,1985,57715,0.0316666666666667,0.0343931386987785,0.920726280436608,581,55730,0.800971723559704
"1488",1049,"IP/ED GENERAL TRANSFUSION",52260,"540148","NS FLUSH BAG",2,53,0.00101415996938385,4,133,0.0377358490566038,0.0300751879699248,1.25471698113208,51,129,0.999999999999994
"1489",1096,"CDU HEADACHE OBSERVATION",61,"34505","HYDROCODONE-ACETAMINOPHEN 5-325 MG PO TABS",1,5,0.0819672131147541,603,24164,0.2,0.0249544777354743,8.01459369817579,4,23561,0.282548586581163
"1490",1098,"CDU GASTROENTERITIS OBSERVATION",62,"198509","ONDANSETRON HCL (PF) 4 MG/2 ML INJ SOLN",1,26,0.419354838709677,705,36939,0.0384615384615385,0.0190855193697718,2.0152209492635,25,36234,0.996086325541603
"1491",1136,"IP ANE ANESTHESIA PREOP",340,"202606","FAMOTIDINE (PF) 20 MG/2 ML IV SOLN",1,60,0.176470588235294,288,4280,0.0166666666666667,0.0672897196261682,0.247685185185185,59,3992,0.19318824784803
"1492",1157,"RETIRED IP NEU ICU STATUS EPILEPTICUS ",25,"11150","PROPOFOL 10 MG/ML IV EMUL",1,1,0.04,135,3592,1,0.0375835189309577,26.6074074074074,0,3457,0.0154339194241659
"1493",1157,"RETIRED IP NEU ICU STATUS EPILEPTICUS ",25,"82384","PANTOPRAZOLE 40 MG IV SOLR",1,5,0.2,688,12925,0.2,0.0532301740812379,3.75726744186047,4,12237,0.641827997743328
"1494",1157,"RETIRED IP NEU ICU STATUS EPILEPTICUS ",25,"530004","MIDAZOLAM 50 MG IN D5W 100 ML IV INFUSION",1,2,0.08,65,1105,0.5,0.0588235294117647,8.5,1,1040,0.255081467105994
"1495",1161,"IP NEU SHIVERING PROTOCOL",102,"9323","BUSPIRONE 10 MG PO TABS",5,46,0.450980392156863,12,457,0.108695652173913,0.0262582056892779,4.13949275362319,41,445,0.0116957790189496
"1496",1161,"IP NEU SHIVERING PROTOCOL",102,"203672","MAGNESIUM SULFATE IN WATER 20 GRAM/500 ML (4 %) IV SOLP",4,16,0.156862745098039,16,65,0.25,0.246153846153846,1.015625,12,49,0.999999999999998
"1497",1238,"IP/ED NEU TPA  ALTEPLASE PROTOCOL",532,"10372","LABETALOL 5 MG/ML IV SOLN",2,77,0.144736842105263,370,5898,0.025974025974026,0.0627331298745337,0.414040014040014,75,5528,0.276167024896776
"1498",1238,"IP/ED NEU TPA  ALTEPLASE PROTOCOL",532,"27838","SODIUM CHLORIDE 0.9 % 0.9 % IV SOLP",2,27,0.0507518796992481,692,19620,0.0740740740740741,0.0352701325178389,2.10019267822736,25,18928,0.568745291136034
"1499",1238,"IP/ED NEU TPA  ALTEPLASE PROTOCOL",532,"86145","ALTEPLASE 100 MG IV SOLR",15,191,0.359022556390977,1,14,0.0785340314136126,0.0714285714285714,1.09947643979058,176,13,0.999999999999999
"1500",1273,"IP POST PROCEDURE ORDERS PARACENTESIS",1054,"8981","ALBUMIN, HUMAN 25 % 25 % IV SOLP",2,119,0.112903225806452,341,9016,0.0168067226890756,0.0378216503992901,0.444367776436088,117,8675,0.339402903091301
"1501",1280,"IP NEU LUMBAR PUNCTURE",367,"126992","LIDOCAINE (PF) 10 MG/ML (1 %) INJ SOLN",1,53,0.14441416893733,457,11068,0.0188679245283019,0.0412902059992772,0.456958837372528,52,10611,0.636173839296513
"1502",1289,"IP GEN VTE PROPHYLAXIS",1541,"110888","ENOXAPARIN 30 MG/0.3 ML SC SYRG",1,25,0.0162232316677482,73,1394,0.04,0.0523672883787661,0.763835616438356,24,1321,0.99999999999998
"1503",1289,"IP GEN VTE PROPHYLAXIS",1541,"110892","ENOXAPARIN 40 MG/0.4 ML SC SYRG",21,334,0.216742375081116,499,13896,0.062874251497006,0.0359096142774899,1.75090300361201,313,13397,0.0143734137641049
"1504",1289,"IP GEN VTE PROPHYLAXIS",1541,"212945","HEPARIN, PORCINE (PF) 5,000 UNIT/0.5 ML INJ SOLN",18,368,0.238805970149254,452,13480,0.0489130434782609,0.0335311572700297,1.45873412851097,350,13028,0.143771588777915
"1505",1289,"IP GEN VTE PROPHYLAXIS",1541,"540493","WARFARIN PER PHARMACY PROTOCOL",1,8,0.00519143413367943,218,6316,0.125,0.0345155161494617,3.62155963302752,7,6098,0.66617469253489
"1506",1307,"IP BMT ALLOGENEIC READMISSION",2258,"101","ACETAMINOPHEN 325 MG PO TABS",16,672,0.297608503100089,981,42092,0.0238095238095238,0.0233060914187969,1.02160089316053,656,41111,0.999999999999996
"1507",1307,"IP BMT ALLOGENEIC READMISSION",2258,"2508","DIPHENHYDRAMINE HCL 50 MG/ML INJ SOLN",10,635,0.281222320637733,399,16019,0.015748031496063,0.0249079218428117,0.632249916128905,625,15620,0.182889829985637
"1508",1307,"IP BMT ALLOGENEIC READMISSION",2258,"2509","DIPHENHYDRAMINE HCL 25 MG PO CAPS",12,645,0.285651018600531,356,12049,0.0186046511627907,0.0295460204166321,0.629683825450745,633,11693,0.135400259955151
"1509",1307,"IP BMT ALLOGENEIC READMISSION",2258,"4560","LOPERAMIDE 2 MG PO CAPS",10,641,0.283879539415412,119,5178,0.015600624024961,0.0229818462726922,0.678823791607126,631,5059,0.291366133601707
"1510",1307,"IP BMT ALLOGENEIC READMISSION",2258,"4572","LORAZEPAM 0.5 MG PO TABS",14,619,0.274136403897254,349,13238,0.0226171243941842,0.0263634990179785,0.857895394642435,605,12889,0.658731815180138
"1511",1307,"IP BMT ALLOGENEIC READMISSION",2258,"6494","PREDNISONE 10 MG PO TABS",1,10,0.00442869796279894,104,4234,0.1,0.0245630609352858,4.07115384615385,9,4130,0.606671125930196
"1512",1307,"IP BMT ALLOGENEIC READMISSION",2258,"6496","PREDNISONE 20 MG PO TABS",2,24,0.0106288751107174,276,7517,0.0833333333333333,0.0367167753092989,2.26962560386473,22,7241,0.504427230065266
"1513",1307,"IP BMT ALLOGENEIC READMISSION",2258,"6497","PREDNISONE 5 MG PO TABS",1,5,0.00221434898139947,108,4678,0.2,0.023086789226165,8.66296296296296,4,4570,0.254933830423203
"1514",1307,"IP BMT ALLOGENEIC READMISSION",2258,"7555","SULFAMETHOXAZOLE-TRIMETHOPRIM 800-160 MG PO TABS",2,33,0.0146147032772365,273,6399,0.0606060606060606,0.0426629160806376,1.42057942057942,31,6126,0.938740084001063
"1515",1307,"IP BMT ALLOGENEIC READMISSION",2258,"7557","SULFAMETHOXAZOLE-TRIMETHOPRIM 400-80 MG PO TABS",1,27,0.0119574844995571,112,3269,0.037037037037037,0.0342612419700214,1.08101851851852,26,3157,0.999999999999994
"1516",1307,"IP BMT ALLOGENEIC READMISSION",2258,"8085","TRAZODONE 50 MG PO TABS",2,121,0.0535872453498671,334,11344,0.0165289256198347,0.0294428772919605,0.561389617459296,119,11010,0.570823799990368
"1517",1307,"IP BMT ALLOGENEIC READMISSION",2258,"9644","CLOTRIMAZOLE 10 MG MM TROC",1,23,0.0101860053144376,29,2750,0.0434782608695652,0.0105454545454545,4.12293853073463,22,2721,0.611183754823578
"1518",1307,"IP BMT ALLOGENEIC READMISSION",2258,"10011","FAMOTIDINE 20 MG PO TABS",31,371,0.164304694419841,472,16960,0.0835579514824798,0.0278301886792453,3.00242130750605,340,16488,6.87182853963978e-10
"1519",1307,"IP BMT ALLOGENEIC READMISSION",2258,"10467","LORAZEPAM 2 MG/ML INJ SOLN",15,631,0.279450841452613,749,20621,0.0237717908082409,0.0363221958197954,0.654470091130488,616,19872,0.118856867997309
"1520",1307,"IP BMT ALLOGENEIC READMISSION",2258,"11624","URSODIOL 300 MG PO CAPS",3,30,0.0132860938883968,49,2387,0.1,0.0205278592375367,4.87142857142857,27,2338,0.0188590604912754
"1521",1307,"IP BMT ALLOGENEIC READMISSION",2258,"14863","POTASSIUM CHLORID-D5-0.45%NACL 20 MEQ/L IV SOLP",5,94,0.04162976085031,314,8762,0.0531914893617021,0.035836566993837,1.4842797126982,89,8448,0.535300369913008
"1522",1307,"IP BMT ALLOGENEIC READMISSION",2258,"15065","FAMOTIDINE 10 MG PO TABS",1,2,0.000885739592559787,11,326,0.5,0.0337423312883436,14.8181818181818,1,315,0.106847309250935
"1523",1307,"IP BMT ALLOGENEIC READMISSION",2258,"16426","NS WITH POTASSIUM CHLORIDE 20 MEQ/L IV SOLP",5,195,0.0863596102745793,118,4415,0.0256410256410256,0.026727066817667,0.959365493263798,190,4297,0.999999999999877
"1524",1307,"IP BMT ALLOGENEIC READMISSION",2258,"16427","POTASSIUM CHLORIDE IN 0.9%NACL 40 MEQ/L IV SOLP",1,20,0.00885739592559787,32,752,0.05,0.0425531914893617,1.175,19,720,1
"1525",1307,"IP BMT ALLOGENEIC READMISSION",2258,"17362","HEPARIN, PORCINE (PF) 100 UNIT/ML IV SYRG",8,621,0.275022143489814,202,8865,0.0128824476650564,0.0227862380146644,0.565360883914478,613,8663,0.138736107205413
"1526",1307,"IP BMT ALLOGENEIC READMISSION",2258,"25119","CIPROFLOXACIN 500 MG PO TABS",1,35,0.0155004428697963,442,10593,0.0285714285714286,0.0417256678938922,0.684744667097608,34,10151,0.999999999999496
"1527",1307,"IP BMT ALLOGENEIC READMISSION",2258,"38285","ALUM-MAG HYDROXIDE-SIMETH 200-200-20 MG/5 ML PO SUSP",9,653,0.289193976970771,71,5546,0.0137825421133231,0.0128020194734944,1.07659124733085,644,5475,0.978700211134168
"1528",1307,"IP BMT ALLOGENEIC READMISSION",2258,"80562","MYCOPHENOLATE MOFETIL 250 MG PO CAPS",1,21,0.00930026572187777,120,3882,0.0476190476190476,0.0309119010819165,1.54047619047619,20,3762,0.999999999999939
"1529",1307,"IP BMT ALLOGENEIC READMISSION",2258,"85078","MYCOPHENOLATE MOFETIL 500 MG PO TABS",1,20,0.00885739592559787,45,1479,0.05,0.0304259634888438,1.64333333333333,19,1434,0.999999999999998
"1530",1307,"IP BMT ALLOGENEIC READMISSION",2258,"92173","ZOLPIDEM 5 MG PO TABS",16,489,0.216563330380868,159,8203,0.032719836400818,0.019383152505181,1.68805545909377,473,8044,0.0609188299254834
"1531",1307,"IP BMT ALLOGENEIC READMISSION",2258,"94670","TACROLIMUS 1 MG PO CAPS",2,53,0.0234720992028344,322,9479,0.0377358490566038,0.0339698280409326,1.1108637056135,51,9157,0.999999999999745
"1532",1307,"IP BMT ALLOGENEIC READMISSION",2258,"95354","ATOVAQUONE 750 MG/5 ML PO SUSP",1,42,0.0186005314437555,36,1709,0.0238095238095238,0.0210649502633119,1.13029100529101,41,1673,0.999999999999965
"1533",1307,"IP BMT ALLOGENEIC READMISSION",2258,"96559","PIPERACILLIN-TAZOBACTAM-DEXTRS 3.375 GRAM/50 ML IV PGBK",5,24,0.0106288751107174,1067,10067,0.208333333333333,0.105989867885169,1.96559668853483,19,9000,0.195810777381399
"1534",1307,"IP BMT ALLOGENEIC READMISSION",2258,"96560","PIPERACILLIN-TAZOBACTAM-DEXTRS 4.5 GRAM/100 ML IV PGBK",2,15,0.00664304694419841,290,2601,0.133333333333333,0.111495578623606,1.19586206896552,13,2311,0.999999999999874
"1535",1307,"IP BMT ALLOGENEIC READMISSION",2258,"110892","ENOXAPARIN 40 MG/0.4 ML SC SYRG",1,9,0.00398582816651904,499,13896,0.111111111111111,0.0359096142774899,3.09418837675351,8,13397,0.752100320369339
"1536",1307,"IP BMT ALLOGENEIC READMISSION",2258,"115288","LEVOFLOXACIN IN D5W 750 MG/150 ML IV PGBK",1,16,0.0070859167404783,208,3699,0.0625,0.0562314138956475,1.11147836538462,15,3491,0.999999999999879
"1537",1307,"IP BMT ALLOGENEIC READMISSION",2258,"117152","GLYCERIN-DIMETHICONE-PETRO, WH TP CREA",8,648,0.286979627989371,19,1429,0.0123456790123457,0.013296011196641,0.928525016244314,640,1410,0.999999999999991
"1538",1307,"IP BMT ALLOGENEIC READMISSION",2258,"124216","VANCOMYCIN IN D5W 1 GRAM/200 ML IV PGBK",1,17,0.00752878653675819,1951,16917,0.0588235294117647,0.115327776792576,0.510055175324871,16,14966,0.726914034307092
"1539",1307,"IP BMT ALLOGENEIC READMISSION",2258,"200345","MAGNESIUM SULFATE IN 0.9 %NACL 1 GRAM/50 ML IV SOLN",10,678,0.300265721877768,410,20810,0.0147492625368732,0.019702066314272,0.748615008273977,668,20400,0.437853390705382
"1540",1307,"IP BMT ALLOGENEIC READMISSION",2258,"200346","MAGNESIUM SULFATE IN 0.9 %NACL 2 GRAM/50 ML IV PGBK",10,675,0.298937112488928,578,30211,0.0148148148148148,0.0191321042004568,0.774343201332821,665,29633,0.503256354849592
"1541",1307,"IP BMT ALLOGENEIC READMISSION",2258,"209037","ACETAMINOPHEN 650 MG/20.3 ML PO SOLN",17,663,0.29362267493357,192,8611,0.0256410256410256,0.0222970618975729,1.14997329059829,646,8419,0.672124228988929
"1542",1307,"IP BMT ALLOGENEIC READMISSION",2258,"209508","METHYLPREDNISOLONE SOD SUC(PF) 40 MG/ML INJ SOLR",1,5,0.00221434898139947,155,3480,0.2,0.0445402298850575,4.49032258064516,4,3325,0.550017114954847
"1543",1307,"IP BMT ALLOGENEIC READMISSION",2258,"209509","METHYLPREDNISOLONE SOD SUC(PF) 125 MG/2 ML INJ SOLR",2,34,0.0150575730735164,275,8000,0.0588235294117647,0.034375,1.71122994652406,32,7725,0.757544925102445
"1544",1307,"IP BMT ALLOGENEIC READMISSION",2258,"210379","HYDROCORTISONE SOD SUCC (PF) 100 MG/2 ML INJ SOLR",11,623,0.275907883082374,313,9164,0.0176565008025682,0.0341553906591008,0.516946240749953,612,8851,0.0347214379294398
"1545",1307,"IP BMT ALLOGENEIC READMISSION",2258,"212945","HEPARIN, PORCINE (PF) 5,000 UNIT/0.5 ML INJ SOLN",1,8,0.00354295837023915,452,13480,0.125,0.0335311572700297,3.72787610619469,7,13028,0.649770163706163
"1546",1307,"IP BMT ALLOGENEIC READMISSION",2258,"520073","MYCOPHENOLATE IVPB",1,12,0.00531443755535872,37,865,0.0833333333333333,0.0427745664739884,1.9481981981982,11,828,0.999999999999938
"1547",1307,"IP BMT ALLOGENEIC READMISSION",2258,"520098","TACROLIMUS IV INFUSION",3,48,0.0212577502214349,87,3271,0.0625,0.0265973708346072,2.34985632183908,45,3184,0.283384271835328
"1548",1307,"IP BMT ALLOGENEIC READMISSION",2258,"540003","TRIPLE MIX",9,616,0.272807794508415,60,2236,0.0146103896103896,0.0268336314847943,0.544480519480519,607,2176,0.109557712168388
"1549",1307,"IP BMT ALLOGENEIC READMISSION",2258,"540132","CYCLOSPORINE MODIFIED (GENGRAF) 25 MG PO CAPS",2,9,0.00398582816651904,30,642,0.222222222222222,0.0467289719626168,4.75555555555556,7,612,0.100580442178359
"1550",1307,"IP BMT ALLOGENEIC READMISSION",2258,"540301","POTASSIUM CHLORIDE ORAL SCALE",7,509,0.225420726306466,105,3653,0.0137524557956778,0.0287434984943882,0.478454485920105,502,3548,0.0700026675845892
"1551",1307,"IP BMT ALLOGENEIC READMISSION",2258,"540302","POTASSIUM CHLORIDE IV SCALE",12,684,0.302922940655447,150,4660,0.0175438596491228,0.0321888412017167,0.545029239766082,672,4510,0.0492180586423604
"1552",1307,"IP BMT ALLOGENEIC READMISSION",2258,"541084","CEFEPIME 2 GRAM/100 ML MINI-BAG PLUS",10,69,0.0305580159433127,277,3459,0.144927536231884,0.0800809482509396,1.80976298854183,59,3182,0.0838650523281628
"1553",1307,"IP BMT ALLOGENEIC READMISSION",2258,"541089","VANCOMYCIN 1 GRAM/100 ML CENTRAL LINE MINI-BAG PLUS",6,32,0.0141718334809566,112,785,0.1875,0.142675159235669,1.31417410714286,26,673,0.652313513205365
"1554",1307,"IP BMT ALLOGENEIC READMISSION",2258,"541119","MEROPENEM IN NS 500 MG/100 ML MINI-BAG PLUS",1,2,0.000885739592559787,19,408,0.5,0.0465686274509804,10.7368421052632,1,389,0.185406353297182
"1555",1307,"IP BMT ALLOGENEIC READMISSION",2258,"541271","PIPERACILLIN-TAZOBACTAM 3.375 GRAM/50 ML IVPB EXTENDED INFUSION",1,27,0.0119574844995571,466,8270,0.037037037037037,0.0563482466747279,0.657288189477031,26,7804,0.986850030574088
"1556",1307,"IP BMT ALLOGENEIC READMISSION",2258,"541273","PIPERACILLIN-TAZOBACTAM 4.5 GRAM/100 ML IVPB EXTENDED INFUSION",2,10,0.00442869796279894,148,1260,0.2,0.117460317460317,1.7027027027027,8,1112,0.753747555693581
"1557",1307,"IP BMT ALLOGENEIC READMISSION",2258,"541544","CEFEPIME 2 G/100 ML EXTENDED INFUSION MINI-BAG PLUS",2,11,0.00487156775907883,60,934,0.181818181818182,0.0642398286937901,2.83030303030303,9,874,0.340412506597774
"1558",1307,"IP BMT ALLOGENEIC READMISSION",2258,"9000000","ZZZ IMS TEMPLATE",1,49,0.0217006200177148,1035,28824,0.0204081632653061,0.0359075770191507,0.56835255841467,48,27789,0.842676157488176
"1559",1309,"IP BMT AUTOLOGOUS READMISSION ORDERS",908,"101","ACETAMINOPHEN 325 MG PO TABS",9,293,0.322687224669604,981,42092,0.0307167235494881,0.0233060914187969,1.31796975295112,284,41111,0.520298485618769
"1560",1309,"IP BMT AUTOLOGOUS READMISSION ORDERS",908,"2508","DIPHENHYDRAMINE HCL 50 MG/ML INJ SOLN",6,287,0.316079295154185,399,16019,0.0209059233449477,0.0249079218428117,0.839328285871473,281,15620,0.80997931342325
"1561",1309,"IP BMT AUTOLOGOUS READMISSION ORDERS",908,"2509","DIPHENHYDRAMINE HCL 25 MG PO CAPS",8,284,0.312775330396476,356,12049,0.028169014084507,0.0295460204166321,0.953394524450071,276,11693,0.999999999999995
"1562",1309,"IP BMT AUTOLOGOUS READMISSION ORDERS",908,"4560","LOPERAMIDE 2 MG PO CAPS",8,302,0.332599118942731,119,5178,0.0264900662251656,0.0229818462726922,1.1526517891925,294,5059,0.843706940510217
"1563",1309,"IP BMT AUTOLOGOUS READMISSION ORDERS",908,"4572","LORAZEPAM 0.5 MG PO TABS",8,271,0.298458149779736,349,13238,0.029520295202952,0.0263634990179785,1.11974116875839,263,12889,0.897013986579153
"1564",1309,"IP BMT AUTOLOGOUS READMISSION ORDERS",908,"8085","TRAZODONE 50 MG PO TABS",2,53,0.0583700440528634,334,11344,0.0377358490566038,0.0294428772919605,1.28166308891651,51,11010,0.999999999999436
"1565",1309,"IP BMT AUTOLOGOUS READMISSION ORDERS",908,"9644","CLOTRIMAZOLE 10 MG MM TROC",1,26,0.0286343612334802,29,2750,0.0384615384615385,0.0105454545454545,3.64721485411141,25,2721,0.676387998128135
"1566",1309,"IP BMT AUTOLOGOUS READMISSION ORDERS",908,"10011","FAMOTIDINE 20 MG PO TABS",14,198,0.218061674008811,472,16960,0.0707070707070707,0.0278301886792453,2.54066084574559,184,16488,0.000673248863469876
"1567",1309,"IP BMT AUTOLOGOUS READMISSION ORDERS",908,"10467","LORAZEPAM 2 MG/ML INJ SOLN",8,283,0.311674008810573,749,20621,0.0282685512367491,0.0363221958197954,0.778272089523369,275,19872,0.575411540903291
"1568",1309,"IP BMT AUTOLOGOUS READMISSION ORDERS",908,"14863","POTASSIUM CHLORID-D5-0.45%NACL 20 MEQ/L IV SOLP",2,71,0.0781938325991189,314,8762,0.028169014084507,0.035836566993837,0.78604108728806,69,8448,0.979515837381003
"1569",1309,"IP BMT AUTOLOGOUS READMISSION ORDERS",908,"15846","HEPARIN (PORCINE) IN 5 % DEX 25,000 UNIT/250 ML(100 UNIT/ML) IV SOLP",7,187,0.205947136563877,68,899,0.0374331550802139,0.0756395995550612,0.494888329663416,180,831,0.0861128035508223
"1570",1309,"IP BMT AUTOLOGOUS READMISSION ORDERS",908,"17362","HEPARIN, PORCINE (PF) 100 UNIT/ML IV SYRG",7,283,0.311674008810573,202,8865,0.0247349823321555,0.0227862380146644,1.08552286324039,276,8663,0.988896766420461
"1571",1309,"IP BMT AUTOLOGOUS READMISSION ORDERS",908,"25119","CIPROFLOXACIN 500 MG PO TABS",2,65,0.0715859030837004,442,10593,0.0307692307692308,0.0417256678938922,0.737417333797424,63,10151,0.897036023289475
"1572",1309,"IP BMT AUTOLOGOUS READMISSION ORDERS",908,"38285","ALUM-MAG HYDROXIDE-SIMETH 200-200-20 MG/5 ML PO SUSP",8,284,0.312775330396476,71,5546,0.028169014084507,0.0128020194734944,2.20035707200952,276,5475,0.0546604450998462
"1573",1309,"IP BMT AUTOLOGOUS READMISSION ORDERS",908,"92173","ZOLPIDEM 5 MG PO TABS",4,218,0.240088105726872,159,8203,0.018348623853211,0.019383152505181,0.94662743061566,214,8044,0.999999999999827
"1574",1309,"IP BMT AUTOLOGOUS READMISSION ORDERS",908,"96559","PIPERACILLIN-TAZOBACTAM-DEXTRS 3.375 GRAM/50 ML IV PGBK",1,12,0.013215859030837,1067,10067,0.0833333333333333,0.105989867885169,0.786238675413933,11,9000,0.999999999999996
"1575",1309,"IP BMT AUTOLOGOUS READMISSION ORDERS",908,"96560","PIPERACILLIN-TAZOBACTAM-DEXTRS 4.5 GRAM/100 ML IV PGBK",1,7,0.00770925110132159,290,2601,0.142857142857143,0.111495578623606,1.28128078817734,6,2311,0.999999999999998
"1576",1309,"IP BMT AUTOLOGOUS READMISSION ORDERS",908,"112593","FILGRASTIM 480 MCG/0.8 ML INJ SYRG",1,35,0.0385462555066079,70,1940,0.0285714285714286,0.0360824742268041,0.791836734693878,34,1870,0.999999999999998
"1577",1309,"IP BMT AUTOLOGOUS READMISSION ORDERS",908,"117152","GLYCERIN-DIMETHICONE-PETRO, WH TP CREA",8,285,0.313876651982379,19,1429,0.0280701754385965,0.013296011196641,2.11117266851339,277,1410,0.116770705816033
"1578",1309,"IP BMT AUTOLOGOUS READMISSION ORDERS",908,"124216","VANCOMYCIN IN D5W 1 GRAM/200 ML IV PGBK",1,15,0.0165198237885463,1951,16917,0.0666666666666667,0.115327776792576,0.578062532034854,14,14966,0.852882890539151
"1579",1309,"IP BMT AUTOLOGOUS READMISSION ORDERS",908,"200345","MAGNESIUM SULFATE IN 0.9 %NACL 1 GRAM/50 ML IV SOLN",6,292,0.3215859030837,410,20810,0.0205479452054795,0.019702066314272,1.0429335115269,286,20400,0.999999999999534
"1580",1309,"IP BMT AUTOLOGOUS READMISSION ORDERS",908,"200346","MAGNESIUM SULFATE IN 0.9 %NACL 2 GRAM/50 ML IV PGBK",5,289,0.318281938325991,578,30211,0.0173010380622837,0.0191321042004568,0.90429353096826,284,29633,0.991678055315456
"1581",1309,"IP BMT AUTOLOGOUS READMISSION ORDERS",908,"209037","ACETAMINOPHEN 650 MG/20.3 ML PO SOLN",9,290,0.319383259911894,192,8611,0.0310344827586207,0.0222970618975729,1.39186422413793,281,8419,0.432953033915548
"1582",1309,"IP BMT AUTOLOGOUS READMISSION ORDERS",908,"210379","HYDROCORTISONE SOD SUCC (PF) 100 MG/2 ML INJ SOLR",7,279,0.30726872246696,313,9164,0.025089605734767,0.0341553906591008,0.734572354483722,272,8851,0.511497923947275
"1583",1309,"IP BMT AUTOLOGOUS READMISSION ORDERS",908,"540003","TRIPLE MIX",8,291,0.320484581497797,60,2236,0.0274914089347079,0.0268336314847943,1.02451317296678,283,2176,1
"1584",1309,"IP BMT AUTOLOGOUS READMISSION ORDERS",908,"540301","POTASSIUM CHLORIDE ORAL SCALE",2,221,0.243392070484582,105,3653,0.00904977375565611,0.0287434984943882,0.31484593837535,219,3548,0.127656189878634
"1585",1309,"IP BMT AUTOLOGOUS READMISSION ORDERS",908,"540302","POTASSIUM CHLORIDE IV SCALE",6,297,0.327092511013216,150,4660,0.0202020202020202,0.0321888412017167,0.627609427609428,291,4510,0.329138537876547
"1586",1309,"IP BMT AUTOLOGOUS READMISSION ORDERS",908,"540960","MEROPENEM IN NS 1 GRAM/100 ML MINI-BAG PLUS",1,2,0.00220264317180617,302,3726,0.5,0.0810520665593129,6.16887417218543,1,3424,0.382426046187656
"1587",1309,"IP BMT AUTOLOGOUS READMISSION ORDERS",908,"541084","CEFEPIME 2 GRAM/100 ML MINI-BAG PLUS",7,75,0.0825991189427313,277,3459,0.0933333333333333,0.0800809482509396,1.16548736462094,68,3182,0.839132503510895
"1588",1309,"IP BMT AUTOLOGOUS READMISSION ORDERS",908,"541089","VANCOMYCIN 1 GRAM/100 ML CENTRAL LINE MINI-BAG PLUS",5,49,0.0539647577092511,112,785,0.102040816326531,0.142675159235669,0.715196793002915,44,673,0.560151959674523
"1589",1309,"IP BMT AUTOLOGOUS READMISSION ORDERS",908,"541544","CEFEPIME 2 G/100 ML EXTENDED INFUSION MINI-BAG PLUS",1,14,0.0154185022026432,60,934,0.0714285714285714,0.0642398286937901,1.11190476190476,13,874,1
"1590",1309,"IP BMT AUTOLOGOUS READMISSION ORDERS",908,"9000000","ZZZ IMS TEMPLATE",4,11,0.0121145374449339,1035,28824,0.363636363636364,0.0359075770191507,10.1270092226614,7,27789,5.11288846215371e-07
"1591",1352,"IP MED CYSTIC FIBROSIS ADMIT",2469,"250","ALBUTEROL SULFATE 2.5 MG /3 ML (0.083 %) INH NEBU",1,62,0.0251113811259619,106,3939,0.0161290322580645,0.0269103833460269,0.599360925136945,61,3833,0.900191212820415
"1592",1352,"IP MED CYSTIC FIBROSIS ADMIT",2469,"1300","CALCIUM CARBONATE 500 MG CALCIUM (1,250 MG) PO TABS",2,51,0.0206561360874848,94,2563,0.0392156862745098,0.03667577058135,1.06925323320818,49,2469,0.999999999999896
"1593",1352,"IP MED CYSTIC FIBROSIS ADMIT",2469,"7327","SODIUM CHLORIDE 3 % INH NEBU",2,76,0.0307816929931146,13,454,0.0263157894736842,0.0286343612334802,0.919028340080972,74,441,0.999999999999997
"1594",1352,"IP MED CYSTIC FIBROSIS ADMIT",2469,"7994","TOBRAMYCIN SULFATE 40 MG/ML INJ SOLN",6,10,0.00405022276225192,8,37,0.6,0.216216216216216,2.775,4,29,0.0494232061382861
"1595",1352,"IP MED CYSTIC FIBROSIS ADMIT",2469,"19483","CALCIUM CARBONATE-VITAMIN D3 500 MG(1,250MG) -200 UNIT PO TABS",2,95,0.0384771162413933,27,2802,0.0210526315789474,0.00963597430406852,2.18479532163743,93,2775,0.565062349187606
"1596",1352,"IP MED CYSTIC FIBROSIS ADMIT",2469,"25424","POLYETHYLENE GLYCOL 3350 17 GRAM PO PWPK",7,361,0.146213041717294,712,36910,0.0193905817174515,0.0192901652668653,1.00520557751564,354,36198,0.999999999999476
"1597",1352,"IP MED CYSTIC FIBROSIS ADMIT",2469,"70536","FLUTICASONE 50 MCG/ACTUATION NASAL SPSN",1,36,0.0145808019441069,57,3947,0.0277777777777778,0.0144413478591335,1.92348927875244,35,3890,0.999999999999916
"1598",1352,"IP MED CYSTIC FIBROSIS ADMIT",2469,"77973","FLUTICASONE-SALMETEROL 250-50 MCG/DOSE INH DSDV",1,28,0.0113406237343054,39,2261,0.0357142857142857,0.0172490048651039,2.07051282051282,27,2222,0.987607539026879
"1599",1352,"IP MED CYSTIC FIBROSIS ADMIT",2469,"78668","IPRATROPIUM-ALBUTEROL 0.5 MG-3 MG(2.5 MG BASE)/3 ML INH NEBU",5,363,0.147023086269745,493,18456,0.0137741046831956,0.0267121803207629,0.515648835766852,358,17963,0.175163425799323
"1600",1352,"IP MED CYSTIC FIBROSIS ADMIT",2469,"78941","TOBRAMYCIN IN 0.225 % NACL 300 MG/5 ML INH NEBU",2,39,0.0157958687727825,9,345,0.0512820512820513,0.0260869565217391,1.96581196581197,37,336,0.698241665637532
"1601",1352,"IP MED CYSTIC FIBROSIS ADMIT",2469,"81505","CIPROFLOXACIN IN D5W 400 MG/200 ML IV PGBK",1,9,0.00364520048602673,242,3682,0.111111111111111,0.0657251493753395,1.69054178145087,8,3440,0.999999999999996
"1602",1352,"IP MED CYSTIC FIBROSIS ADMIT",2469,"84953","PANTOPRAZOLE 20 MG PO TBEC",1,8,0.00324017820980154,41,1209,0.125,0.0339123242349049,3.6859756097561,7,1168,0.663474579820909
"1603",1352,"IP MED CYSTIC FIBROSIS ADMIT",2469,"88043","PANTOPRAZOLE 40 MG PO TBEC",2,157,0.0635884973673552,624,31884,0.0127388535031847,0.0195709446744449,0.650906418422342,155,31260,0.742929252082316
"1604",1352,"IP MED CYSTIC FIBROSIS ADMIT",2469,"89401","FLUTICASONE-SALMETEROL 500-50 MCG/DOSE INH DSDV",2,60,0.0243013365735115,15,1230,0.0333333333333333,0.0121951219512195,2.73333333333333,58,1215,0.410885905715656
"1605",1352,"IP MED CYSTIC FIBROSIS ADMIT",2469,"92642","LEVALBUTEROL HCL 1.25 MG/3 ML INH NEBU",1,31,0.012555690562981,46,1262,0.032258064516129,0.0364500792393027,0.884992987377279,30,1216,0.999999999999997
"1606",1352,"IP MED CYSTIC FIBROSIS ADMIT",2469,"94621","AZTREONAM IN DEXTROSE(ISO-OSM) 2 GRAM/50 ML IV PGBK",1,5,0.00202511138112596,3,54,0.2,0.0555555555555556,3.6,4,51,0.764632446680992
"1607",1352,"IP MED CYSTIC FIBROSIS ADMIT",2469,"95901","PHYTONADIONE 5 MG PO TABS",3,52,0.02106115836371,137,2851,0.0576923076923077,0.0480533146264469,1.20058955642897,49,2714,0.999999999999996
"1608",1352,"IP MED CYSTIC FIBROSIS ADMIT",2469,"110892","ENOXAPARIN 40 MG/0.4 ML SC SYRG",4,25,0.0101255569056298,499,13896,0.16,0.0359096142774899,4.45563126252505,21,13397,0.00534668750390256
"1609",1352,"IP MED CYSTIC FIBROSIS ADMIT",2469,"112321","LINEZOLID 600 MG/300 ML IV SOLP",2,72,0.0291616038882139,51,1417,0.0277777777777778,0.0359915314043754,0.771786492374728,70,1366,0.967340362301028
"1610",1352,"IP MED CYSTIC FIBROSIS ADMIT",2469,"200453","SODIUM CHLORIDE 7 % INH NEBU",2,316,0.127987039287161,9,470,0.00632911392405063,0.0191489361702128,0.330520393811533,314,461,0.23384274417268
"1611",1352,"IP MED CYSTIC FIBROSIS ADMIT",2469,"208092","LIPASE-PROTEASE-AMYLASE 24,000-76,000 -120,000 UNIT PO CPDR",4,137,0.0554880518428514,55,1851,0.0291970802919708,0.0297136682874122,0.982614465826145,133,1796,0.999999999999999
"1612",1352,"IP MED CYSTIC FIBROSIS ADMIT",2469,"210750","LIPASE-PROTEASE-AMYLASE 16,800-40,000 -70,000 UNIT PO CPDR",3,13,0.0052652895909275,5,140,0.230769230769231,0.0357142857142857,6.46153846153846,10,135,0.0177466687799448
"1613",1352,"IP MED CYSTIC FIBROSIS ADMIT",2469,"221975","MULTIVIT-MIN-FA-COENZYME Q10 100-10 MCG-MG PO CAPS",2,157,0.0635884973673552,10,590,0.0127388535031847,0.0169491525423729,0.751592356687898,155,580,0.987412016512947
"1614",1352,"IP MED CYSTIC FIBROSIS ADMIT",2469,"229996","LACTOBACILLUS RHAMNOSUS GG 15 BILLION CELL PO CPSP",1,71,0.0287565816119887,52,4244,0.0140845070422535,0.0122525918944392,1.14951245937161,70,4192,0.999999999999999
"1615",1352,"IP MED CYSTIC FIBROSIS ADMIT",2469,"520011","TOBRAMYCIN IVPB",3,201,0.0814094775212637,35,711,0.0149253731343284,0.0492264416315049,0.30319829424307,198,676,0.0513089878097182
"1616",1352,"IP MED CYSTIC FIBROSIS ADMIT",2469,"520045","MEROPENEM CUSTOM IVPB",2,86,0.0348319157553665,100,1654,0.0232558139534884,0.060459492140266,0.384651162790698,84,1554,0.231494356961273
"1617",1352,"IP MED CYSTIC FIBROSIS ADMIT",2469,"520046","VANCOMYCIN IVPB (CUSTOM DOSE)",7,51,0.0206561360874848,1808,23328,0.137254901960784,0.0775034293552812,1.77095262883915,44,21520,0.183205579435171
"1618",1352,"IP MED CYSTIC FIBROSIS ADMIT",2469,"520050","COLISTIMETHATE (COLISTIN) IVPB",3,50,0.0202511138112596,10,147,0.06,0.0680272108843537,0.882,47,137,0.999999999999998
"1619",1352,"IP MED CYSTIC FIBROSIS ADMIT",2469,"540672","CIPROFLOXACIN IN NS IV 400 MG/250 ML IV",13,74,0.0299716484406642,1,39,0.175675675675676,0.0256410256410256,6.85135135135135,61,38,0.0453788184777699
"1620",1352,"IP MED CYSTIC FIBROSIS ADMIT",2469,"540677","PIPERACILLIN-TAZOBACTAM 3.375 GRAM IN NS IV SOLN",8,36,0.0145808019441069,17,277,0.222222222222222,0.0613718411552347,3.62091503267974,28,260,0.00250886094884938
"1621",1352,"IP MED CYSTIC FIBROSIS ADMIT",2469,"540678","PIPERACILLIN-TAZOBACTAM 4.5 GRAM IN NS IV SOLN",4,66,0.0267314702308627,8,95,0.0606060606060606,0.0842105263157895,0.71969696969697,62,87,0.798105891081707
"1622",1352,"IP MED CYSTIC FIBROSIS ADMIT",2469,"540692","NS/BUDESONIDE NASAL IRRIGATION",2,321,0.130012150668287,14,318,0.00623052959501558,0.0440251572327044,0.141522029372497,319,304,0.0050451149066541
"1623",1352,"IP MED CYSTIC FIBROSIS ADMIT",2469,"540699","CF ENEMA SOLUTION",2,15,0.00607533414337789,8,509,0.133333333333333,0.0157170923379175,8.48333333333333,13,501,0.0201253347998847
"1624",1352,"IP MED CYSTIC FIBROSIS ADMIT",2469,"540967","PIPERACILLIN-TAZOBACTAM 4.5 GRAM/100 ML MINI-BAG PLUS",1,19,0.00769542324827866,135,2073,0.0526315789473684,0.065123010130246,0.808187134502924,18,1938,0.999999999999999
"1625",1352,"IP MED CYSTIC FIBROSIS ADMIT",2469,"541098","CEFEPIME 1 GRAM/50 ML MINI-BAG PLUS",2,3,0.00121506682867558,199,1387,0.666666666666667,0.143475126171593,4.6465661641541,1,1188,0.0797504412836874
"1626",1352,"IP MED CYSTIC FIBROSIS ADMIT",2469,"541107","CEFTAZIDIME 2 GRAM/50 ML MINI-BAG PLUS",2,92,0.0372620494127177,18,257,0.0217391304347826,0.0700389105058366,0.310386473429952,90,239,0.14731719676617
"1627",1355,"IP GEN NEUTROPENIC FEVERS",407,"101","ACETAMINOPHEN 325 MG PO TABS",1,25,0.0614250614250614,981,42092,0.04,0.0233060914187969,1.71628950050968,24,41111,0.999999999999996
"1628",1355,"IP GEN NEUTROPENIC FEVERS",407,"7555","SULFAMETHOXAZOLE-TRIMETHOPRIM 800-160 MG PO TABS",2,3,0.00737100737100737,273,6399,0.666666666666667,0.0426629160806376,15.6263736263736,1,6126,9.41364222614971e-05
"1629",1355,"IP GEN NEUTROPENIC FEVERS",407,"96559","PIPERACILLIN-TAZOBACTAM-DEXTRS 3.375 GRAM/50 ML IV PGBK",10,27,0.0663390663390663,1067,10067,0.37037037037037,0.105989867885169,3.49439411295081,17,9000,3.60097047567243e-05
"1630",1355,"IP GEN NEUTROPENIC FEVERS",407,"112593","FILGRASTIM 480 MCG/0.8 ML INJ SYRG",2,6,0.0147420147420147,70,1940,0.333333333333333,0.0360824742268041,9.23809523809524,4,1870,0.00563423744922943
"1631",1355,"IP GEN NEUTROPENIC FEVERS",407,"520045","MEROPENEM CUSTOM IVPB",1,2,0.00491400491400491,100,1654,0.5,0.060459492140266,8.27,1,1554,0.263727453442821
"1632",1355,"IP GEN NEUTROPENIC FEVERS",407,"520046","VANCOMYCIN IVPB (CUSTOM DOSE)",13,46,0.113022113022113,1808,23328,0.282608695652174,0.0775034293552812,3.64640246248557,33,21520,9.12077991868073e-07
"1633",1355,"IP GEN NEUTROPENIC FEVERS",407,"540960","MEROPENEM IN NS 1 GRAM/100 ML MINI-BAG PLUS",1,4,0.00982800982800983,302,3726,0.25,0.0810520665593129,3.08443708609272,3,3424,0.748527920988681
"1634",1355,"IP GEN NEUTROPENIC FEVERS",407,"541084","CEFEPIME 2 GRAM/100 ML MINI-BAG PLUS",4,95,0.233415233415233,277,3459,0.0421052631578947,0.0800809482509396,0.525783773513205,91,3182,0.245828693449978
"1635",1355,"IP GEN NEUTROPENIC FEVERS",407,"541271","PIPERACILLIN-TAZOBACTAM 3.375 GRAM/50 ML IVPB EXTENDED INFUSION",1,29,0.0712530712530713,466,8270,0.0344827586206897,0.0563482466747279,0.611957969513098,28,7804,0.915218235797089
"1636",1355,"IP GEN NEUTROPENIC FEVERS",407,"541544","CEFEPIME 2 G/100 ML EXTENDED INFUSION MINI-BAG PLUS",2,28,0.0687960687960688,60,934,0.0714285714285714,0.0642398286937901,1.11190476190476,26,874,0.999999999999999
"1637",1355,"IP GEN NEUTROPENIC FEVERS",407,"541547","MEROPENEM 1 G/100 ML EXTENDED INFUSION MINI-BAG PLUS",1,4,0.00982800982800983,71,1342,0.25,0.0529061102831595,4.72535211267606,3,1271,0.524424189782573
"1638",1437,"IP PICC LINE PLACEMENT / EXCHANGE",17694,"81839","LIDOCAINE 4 % TP CREA",67,8876,0.501638973663389,31,996,0.00754844524560613,0.0311244979919679,0.242524240794313,8809,965,3.70751194033956e-12
"1639",1437,"IP PICC LINE PLACEMENT / EXCHANGE",17694,"126992","LIDOCAINE (PF) 10 MG/ML (1 %) INJ SOLN",62,8914,0.50378659432576,457,11068,0.00695535113304914,0.0412902059992772,0.168450385865619,8852,10611,1.1323991717171e-51
"1640",1458,"RADIOLOGY CONTRAST DYE PREMEDICATION",827,"2508","DIPHENHYDRAMINE HCL 50 MG/ML INJ SOLN",14,175,0.211608222490931,399,16019,0.08,0.0249079218428117,3.21182957393484,161,15620,1.3194538993301e-05
"1641",1458,"RADIOLOGY CONTRAST DYE PREMEDICATION",827,"2509","DIPHENHYDRAMINE HCL 25 MG PO CAPS",6,106,0.128174123337364,356,12049,0.0566037735849057,0.0295460204166321,1.91578333686665,100,11693,0.178717316407456
"1642",1458,"RADIOLOGY CONTRAST DYE PREMEDICATION",827,"2510","DIPHENHYDRAMINE HCL 50 MG PO CAPS",5,53,0.064087061668682,37,867,0.0943396226415094,0.0426758938869665,2.21060683324834,48,830,0.158446369870284
"1643",1458,"RADIOLOGY CONTRAST DYE PREMEDICATION",827,"6498","PREDNISONE 50 MG PO TABS",13,145,0.175332527206771,34,1011,0.0896551724137931,0.0336300692383778,2.66592292089249,132,977,0.00298083412425215
"1644",1458,"RADIOLOGY CONTRAST DYE PREMEDICATION",827,"209508","METHYLPREDNISOLONE SOD SUC(PF) 40 MG/ML INJ SOLR",18,166,0.200725513905683,155,3480,0.108433734939759,0.0445402298850575,2.43451224251846,148,3325,0.000322985646411063
"1645",1458,"RADIOLOGY CONTRAST DYE PREMEDICATION",827,"500027","D5W WITH SODIUM BICARBONATE 154 MEQ/L  IV INFUSION FOR CONTRAST STUDY",9,121,0.146311970979444,54,1287,0.0743801652892562,0.041958041958042,1.77272727272727,112,1233,0.155808210365092
"1646",1458,"RADIOLOGY CONTRAST DYE PREMEDICATION",827,"540184","ACETYLCYSTEINE 20 % (200MG/ML) ORAL SOLN",7,107,0.129383313180169,77,1458,0.0654205607476635,0.0528120713305898,1.23874256584537,100,1381,0.736599369022655
"1647",1458,"RADIOLOGY CONTRAST DYE PREMEDICATION",827,"9000000","ZZZ IMS TEMPLATE",3,42,0.0507859733978235,1035,28824,0.0714285714285714,0.0359075770191507,1.98923395445135,39,27789,0.411749914843252
"1648",1489,"IP ICU ADULT ORGAN DONOR ORDERS (GREATER THAN 40KG)",97,"250","ALBUTEROL SULFATE 2.5 MG /3 ML (0.083 %) INH NEBU",1,26,0.268041237113402,106,3939,0.0384615384615385,0.0269103833460269,1.42924528301887,25,3833,0.999999999999999
"1649",1489,"IP ICU ADULT ORGAN DONOR ORDERS (GREATER THAN 40KG)",97,"14863","POTASSIUM CHLORID-D5-0.45%NACL 20 MEQ/L IV SOLP",1,9,0.0927835051546392,314,8762,0.111111111111111,0.035836566993837,3.10049539985846,8,8448,0.751367403549212
"1650",1489,"IP ICU ADULT ORGAN DONOR ORDERS (GREATER THAN 40KG)",97,"40196","ALBUTEROL SULFATE 90 MCG/ACTUATION INH HFAA",1,7,0.0721649484536082,110,6310,0.142857142857143,0.01743264659271,8.19480519480519,6,6200,0.277871628909863
"1651",1489,"IP ICU ADULT ORGAN DONOR ORDERS (GREATER THAN 40KG)",97,"82384","PANTOPRAZOLE 40 MG IV SOLR",3,25,0.257731958762887,688,12925,0.12,0.0532301740812379,2.25436046511628,22,12237,0.298977802158394
"1652",1489,"IP ICU ADULT ORGAN DONOR ORDERS (GREATER THAN 40KG)",97,"96559","PIPERACILLIN-TAZOBACTAM-DEXTRS 3.375 GRAM/50 ML IV PGBK",1,18,0.185567010309278,1067,10067,0.0555555555555556,0.105989867885169,0.524159116942622,17,9000,0.755480554599885
"1653",1489,"IP ICU ADULT ORGAN DONOR ORDERS (GREATER THAN 40KG)",97,"210741","PHENYLEPHRINE IN 0.9% NACL(PF) 40 MG/250 ML (160 MCG/ML) IV SOLN",1,7,0.0721649484536082,43,1494,0.142857142857143,0.0287817938420348,4.96345514950166,6,1451,0.507907526234309
"1654",1489,"IP ICU ADULT ORGAN DONOR ORDERS (GREATER THAN 40KG)",97,"222249","LEVOTHYROXINE 100 MCG IV SOLR",1,19,0.195876288659794,49,1184,0.0526315789473684,0.0413851351351351,1.27175080558539,18,1135,0.999999999999963
"1655",1489,"IP ICU ADULT ORGAN DONOR ORDERS (GREATER THAN 40KG)",97,"520078","METHYLPREDNISOLONE IVPB",2,30,0.309278350515464,342,2212,0.0666666666666667,0.154611211573237,0.431189083820663,28,1870,0.28347147239036
"1656",1489,"IP ICU ADULT ORGAN DONOR ORDERS (GREATER THAN 40KG)",97,"520087","DESMOPRESSIN IVPB",1,9,0.0927835051546392,42,903,0.111111111111111,0.0465116279069767,2.38888888888889,8,861,0.904820506446234
"1657",1489,"IP ICU ADULT ORGAN DONOR ORDERS (GREATER THAN 40KG)",97,"540304","MAGNESIUM SULFATE IV SCALE ",1,26,0.268041237113402,78,4104,0.0384615384615385,0.0190058479532164,2.02366863905325,25,4026,0.996947738800466
"1658",1489,"IP ICU ADULT ORGAN DONOR ORDERS (GREATER THAN 40KG)",97,"541271","PIPERACILLIN-TAZOBACTAM 3.375 GRAM/50 ML IVPB EXTENDED INFUSION",1,18,0.185567010309278,466,8270,0.0555555555555556,0.0563482466747279,0.985932284215546,17,7804,0.999999999999831
"1659",1492,"DRUG DESENSITIZATION PROTOCOL",50,"540138","DESENSITIZATION DRUG HELP ORDER",5,9,0.18,6,38,0.555555555555556,0.157894736842105,3.51851851851852,4,32,0.0361038039953819
"1660",1518,"IP SUR DAY OF SURGERY ORDERS",930,"4318","LACTATED RINGERS IV SOLP",6,93,0.1,135,4847,0.0645161290322581,0.0278522797606767,2.31636798088411,87,4712,0.0736261847040524
"1661",1518,"IP SUR DAY OF SURGERY ORDERS",930,"5018","METRONIDAZOLE IN NACL (ISO-OS) 500 MG/100 ML IV PGBK",2,16,0.0172043010752688,223,3847,0.125,0.0579672472056148,2.15639013452915,14,3624,0.543418938908519
"1662",1518,"IP SUR DAY OF SURGERY ORDERS",930,"9626","CLINDAMYCIN IN 5 % DEXTROSE 600 MG/50 ML IV PGBK",1,6,0.00645161290322581,70,1432,0.166666666666667,0.0488826815642458,3.40952380952381,5,1362,0.700417481270438
"1663",1518,"IP SUR DAY OF SURGERY ORDERS",930,"25365","CEFAZOLIN IN DEXTROSE (ISO-OS) 1 GRAM/50 ML IV PGBK",8,197,0.211827956989247,258,5335,0.0406091370558376,0.0483598875351453,0.839727698422067,189,5077,0.741556171851041
"1664",1518,"IP SUR DAY OF SURGERY ORDERS",930,"81505","CIPROFLOXACIN IN D5W 400 MG/200 ML IV PGBK",2,6,0.00645161290322581,242,3682,0.333333333333333,0.0657251493753395,5.07162534435262,4,3440,0.0698095490274859
"1665",1518,"IP SUR DAY OF SURGERY ORDERS",930,"236263","CEFAZOLIN IN DEXTROSE (ISO-OS) 2 GRAM/100 ML IV PGBK",8,41,0.0440860215053763,111,2584,0.195121951219512,0.0429566563467492,4.54229839595693,33,2473,1.9680707993012e-05
"1666",1518,"IP SUR DAY OF SURGERY ORDERS",930,"520064","CEFAZOLIN 2 G IVPB",1,35,0.0376344086021505,109,2674,0.0285714285714286,0.0407629020194465,0.70091743119266,34,2565,0.999999999999997
"1667",1518,"IP SUR DAY OF SURGERY ORDERS",930,"541110","ERTAPENEM 1 GRAM/50 ML MINI-BAG PLUS",7,103,0.110752688172043,72,1340,0.0679611650485437,0.0537313432835821,1.26483279395901,96,1268,0.698738490921498
"1668",1521,"NURSING TRIAGE FEVER PROTOCOL",114,"102","ACETAMINOPHEN 500 MG PO TABS",1,34,0.298245614035088,392,15968,0.0294117647058824,0.0245490981963928,1.19807923169268,33,15576,0.999999999999967
"1669",1522,"NURSING TRIAGE FLANK PAIN PROTOCOL",26,"540102","NS IV BOLUS",2,8,0.307692307692308,2225,80957,0.25,0.0274837259285794,9.09629213483146,6,78732,0.00565672474764662
"1670",1523,"NURSING TRIAGE  GASTROINTESTINAL BLEEDING, SYMPTOMS OF PROTOCOL",187,"27838","SODIUM CHLORIDE 0.9 % 0.9 % IV SOLP",5,70,0.374331550802139,692,19620,0.0714285714285714,0.0352701325178389,2.0251857968621,65,18928,0.190107485653738
"1671",1526,"NURSING TRIAGE ADULT NAUSEA/VOMITING  PROTOCOL ",345,"27838","SODIUM CHLORIDE 0.9 % 0.9 % IV SOLP",1,4,0.0115942028985507,692,19620,0.25,0.0352701325178389,7.08815028901734,3,18928,0.331086991670267
"1672",1526,"NURSING TRIAGE ADULT NAUSEA/VOMITING  PROTOCOL ",345,"198509","ONDANSETRON HCL (PF) 4 MG/2 ML INJ SOLN",3,144,0.417391304347826,705,36939,0.0208333333333333,0.0190855193697718,1.0915780141844,141,36234,0.999999999998327
"1673",1526,"NURSING TRIAGE ADULT NAUSEA/VOMITING  PROTOCOL ",345,"540102","NS IV BOLUS",6,94,0.272463768115942,2225,80957,0.0638297872340425,0.0274837259285794,2.32245756633995,88,78732,0.0661816350094859
"1674",1553,"IP TRS  KIDNEY/PANCREAS TRANSPLANT RECIPIENT PREOP",336,"5002","METOCLOPRAMIDE HCL 5 MG/ML INJ SOLN",1,9,0.0267857142857143,346,10128,0.111111111111111,0.0341627172195893,3.252408477842,8,9782,0.724835763883227
"1675",1553,"IP TRS  KIDNEY/PANCREAS TRANSPLANT RECIPIENT PREOP",336,"110892","ENOXAPARIN 40 MG/0.4 ML SC SYRG",1,1,0.00297619047619048,499,13896,1,0.0359096142774899,27.8476953907816,0,13397,0.0127154320473097
"1676",1553,"IP TRS  KIDNEY/PANCREAS TRANSPLANT RECIPIENT PREOP",336,"198509","ONDANSETRON HCL (PF) 4 MG/2 ML INJ SOLN",1,24,0.0714285714285714,705,36939,0.0416666666666667,0.0190855193697718,2.18315602836879,23,36234,0.950521822820235
"1677",1554,"RETIRED IP GYN LAPAROSCOPY POSTOP",295,"2566","DOCUSATE SODIUM 100 MG PO CAPS",1,72,0.24406779661017,542,37509,0.0138888888888889,0.0144498653656456,0.961177736777368,71,36967,0.999999999997141
"1678",1554,"RETIRED IP GYN LAPAROSCOPY POSTOP",295,"4318","LACTATED RINGERS IV SOLP",1,79,0.267796610169492,135,4847,0.0126582278481013,0.0278522797606767,0.454477262072199,78,4712,0.637306379563023
"1679",1554,"RETIRED IP GYN LAPAROSCOPY POSTOP",295,"5002","METOCLOPRAMIDE HCL 5 MG/ML INJ SOLN",2,115,0.389830508474576,346,10128,0.0173913043478261,0.0341627172195893,0.509072631314401,113,9782,0.466394749419217
"1680",1554,"RETIRED IP GYN LAPAROSCOPY POSTOP",295,"5940","OXYCODONE-ACETAMINOPHEN 5-325 MG PO TABS",2,9,0.0305084745762712,218,7862,0.222222222222222,0.0277283134062579,8.01427115188583,7,7644,0.0115326983692341
"1681",1554,"RETIRED IP GYN LAPAROSCOPY POSTOP",295,"22472","KETOROLAC 15 MG/ML INJ SOLN",1,20,0.0677966101694915,215,5031,0.05,0.0427350427350427,1.17,19,4816,0.999999999999908
"1682",1554,"RETIRED IP GYN LAPAROSCOPY POSTOP",295,"34505","HYDROCODONE-ACETAMINOPHEN 5-325 MG PO TABS",1,2,0.00677966101694915,603,24164,0.5,0.0249544777354743,20.0364842454395,1,23561,0.0415013714707364
"1683",1554,"RETIRED IP GYN LAPAROSCOPY POSTOP",295,"198509","ONDANSETRON HCL (PF) 4 MG/2 ML INJ SOLN",2,127,0.430508474576271,705,36939,0.015748031496063,0.0190855193697718,0.825129837493718,125,36234,0.999999999999972
"1684",1554,"RETIRED IP GYN LAPAROSCOPY POSTOP",295,"202606","FAMOTIDINE (PF) 20 MG/2 ML IV SOLN",2,7,0.023728813559322,288,4280,0.285714285714286,0.0672897196261682,4.24603174603175,5,3992,0.122076800308768
"1685",1557,"IP ATIC INTRAVENOUS GAMMA GLOBULIN",111,"101","ACETAMINOPHEN 325 MG PO TABS",3,53,0.477477477477477,981,42092,0.0566037735849057,0.0233060914187969,2.42871155732502,50,41111,0.25047730831482
"1686",1557,"IP ATIC INTRAVENOUS GAMMA GLOBULIN",111,"2508","DIPHENHYDRAMINE HCL 50 MG/ML INJ SOLN",4,96,0.864864864864865,399,16019,0.0416666666666667,0.0249079218428117,1.67282790309106,92,15620,0.471126835987811
"1687",1557,"IP ATIC INTRAVENOUS GAMMA GLOBULIN",111,"210379","HYDROCORTISONE SOD SUCC (PF) 100 MG/2 ML INJ SOLR",1,41,0.369369369369369,313,9164,0.024390243902439,0.0341553906591008,0.714096470038183,40,8851,0.999999999999969
"1688",1557,"IP ATIC INTRAVENOUS GAMMA GLOBULIN",111,"212610","IMMUNE GLOBULIN(HUM),CAPR(IGG) 10 GRAM/100 ML (10 %) INJ SOLN",3,46,0.414414414414414,73,1504,0.0652173913043478,0.0485372340425532,1.34365693865396,43,1431,0.865410437053311
"1689",1558,"IP ATIC INFLIXIMAB (REMICADE) INFUSION",22,"101","ACETAMINOPHEN 325 MG PO TABS",2,8,0.363636363636364,981,42092,0.25,0.0233060914187969,10.7268093781855,6,41111,0.00210608249038196
"1690",1558,"IP ATIC INFLIXIMAB (REMICADE) INFUSION",22,"2508","DIPHENHYDRAMINE HCL 50 MG/ML INJ SOLN",2,7,0.318181818181818,399,16019,0.285714285714286,0.0249079218428117,11.4708199069101,5,15620,0.00134279952479121
"1691",1558,"IP ATIC INFLIXIMAB (REMICADE) INFUSION",22,"2509","DIPHENHYDRAMINE HCL 25 MG PO CAPS",2,10,0.454545454545455,356,12049,0.2,0.0295460204166321,6.76910112359551,8,11693,0.0249233406134419
"1692",1558,"IP ATIC INFLIXIMAB (REMICADE) INFUSION",22,"520116","INFLIXIMAB IV INFUSION",2,11,0.5,3,64,0.181818181818182,0.046875,3.87878787878788,9,61,0.315774846185011
"1693",1564,"IP CAPR CARDIOVERSION",58,"27838","SODIUM CHLORIDE 0.9 % 0.9 % IV SOLP",1,26,0.448275862068966,692,19620,0.0384615384615385,0.0352701325178389,1.09048465984882,25,18928,0.999999999999981
"1694",1582,"IP REN HEMODIALYSIS",21812,"101","ACETAMINOPHEN 325 MG PO TABS",1,4,0.000183385292499542,981,42092,0.25,0.0233060914187969,10.7268093781855,3,41111,0.177904126837166
"1695",1582,"IP REN HEMODIALYSIS",21812,"2508","DIPHENHYDRAMINE HCL 50 MG/ML INJ SOLN",4,227,0.010407115349349,399,16019,0.0176211453744493,0.0249079218428117,0.707451448003268,223,15620,0.626936377240407
"1696",1582,"IP REN HEMODIALYSIS",21812,"2509","DIPHENHYDRAMINE HCL 25 MG PO CAPS",1,4,0.000183385292499542,356,12049,0.25,0.0295460204166321,8.46137640449438,3,11693,0.260421137830905
"1697",1582,"IP REN HEMODIALYSIS",21812,"4750","MANNITOL 25 % 25 % IV SOLN",6,303,0.0138914359068403,21,64,0.0198019801980198,0.328125,0.0603488920320603,297,43,8.70020259553855e-17
"1698",1582,"IP REN HEMODIALYSIS",21812,"8981","ALBUMIN, HUMAN 25 % 25 % IV SOLP",1,128,0.00586832935998533,341,9016,0.0078125,0.0378216503992901,0.206561583577713,127,8675,0.123024383578926
"1699",1582,"IP REN HEMODIALYSIS",21812,"8982","ALBUMIN, HUMAN 5 % 5 % IV SOLP",3,29,0.00132954337062168,537,23182,0.103448275862069,0.0231645241998102,4.46580620304373,26,22645,0.0244520441925182
"1700",1582,"IP REN HEMODIALYSIS",21812,"9348","CALCITRIOL 1 MCG/ML IV SOLN",2,98,0.00449293966623877,3,54,0.0204081632653061,0.0555555555555556,0.36734693877551,96,51,0.491679751591955
"1701",1582,"IP REN HEMODIALYSIS",21812,"10176","HEPARIN (PORCINE) 1,000 UNIT/ML INJ SOLN",2,973,0.0446084724005135,164,2898,0.00205549845837616,0.0565907522429262,0.0363221617827689,971,2734,7.29777517086442e-13
"1702",1582,"IP REN HEMODIALYSIS",21812,"25365","CEFAZOLIN IN DEXTROSE (ISO-OS) 1 GRAM/50 ML IV PGBK",1,2,9.16926462497708e-05,258,5335,0.5,0.0483598875351453,10.3391472868217,1,5077,0.184772868055709
"1703",1582,"IP REN HEMODIALYSIS",21812,"77542","EPOETIN ALFA 2,000 UNIT/ML INJ SOLN",13,352,0.0161379057399597,58,299,0.0369318181818182,0.193979933110368,0.190389890282132,339,241,3.38901089079543e-10
"1704",1582,"IP REN HEMODIALYSIS",21812,"77641","EPOETIN ALFA 4,000 UNIT/ML INJ SOLN",13,878,0.0402530717036494,35,370,0.0148063781321185,0.0945945945945946,0.156524568825252,865,335,6.45485902553526e-11
"1705",1582,"IP REN HEMODIALYSIS",21812,"91568","EPOETIN ALFA 3,000 UNIT/ML INJ SOLN",7,564,0.0258573262424354,7,186,0.0124113475177305,0.0376344086021505,0.329787234042553,557,179,0.0585329650096354
"1706",1582,"IP REN HEMODIALYSIS",21812,"94501","EPOETIN ALFA 10,000 UNIT/ML INJ SOLN",17,843,0.0386484503942784,43,1003,0.0201660735468565,0.0428713858424726,0.470385389941792,826,960,0.00909371604090168
"1707",1582,"IP REN HEMODIALYSIS",21812,"94623","ALTEPLASE 2 MG INJ SOLR",11,1098,0.0503392627911242,201,12455,0.0100182149362477,0.0161380971497391,0.620780432989878,1087,12254,0.14992408003314
"1708",1582,"IP REN HEMODIALYSIS",21812,"126580","HEPARIN, PORCINE (PF) 1,000 UNIT/ML INJ SOLN",67,7403,0.339400330093526,58,653,0.00905038497906254,0.0888208269525268,0.101894851574618,7336,595,3.57869534903023e-55
"1709",1582,"IP REN HEMODIALYSIS",21812,"126992","LIDOCAINE (PF) 10 MG/ML (1 %) INJ SOLN",3,866,0.0397029158261507,457,11068,0.00346420323325635,0.0412902059992772,0.0838989089402217,863,10611,4.32881030771955e-08
"1710",1582,"IP REN HEMODIALYSIS",21812,"127602","DARBEPOETIN ALFA IN POLYSORBAT 25 MCG/0.42 ML INJ SYRG",1,7,0.000320924261874198,2,21,0.142857142857143,0.0952380952380952,1.5,6,19,1
"1711",1582,"IP REN HEMODIALYSIS",21812,"209508","METHYLPREDNISOLONE SOD SUC(PF) 40 MG/ML INJ SOLR",1,9,0.000412616908123968,155,3480,0.111111111111111,0.0445402298850575,2.49462365591398,8,3325,0.874766125316319
"1712",1582,"IP REN HEMODIALYSIS",21812,"212610","IMMUNE GLOBULIN(HUM),CAPR(IGG) 10 GRAM/100 ML (10 %) INJ SOLN",1,9,0.000412616908123968,73,1504,0.111111111111111,0.0485372340425532,2.28919330289193,8,1431,0.926125466583651
"1713",1582,"IP REN HEMODIALYSIS",21812,"520124","IRON SUCROSE IVPB (<300MG)",2,96,0.004401247019989,26,603,0.0208333333333333,0.0431177446102819,0.483173076923077,94,577,0.450858089674223
"1714",1582,"IP REN HEMODIALYSIS",21812,"520126","FERRIC GLUCONATE COMPLEX IV INFUSION",3,86,0.00394278378874014,5,68,0.0348837209302326,0.0735294117647059,0.474418604651163,83,63,0.479260790516986
"1715",1586,"IP REN HEMODIALYSIS/PUF",3043,"94623","ALTEPLASE 2 MG INJ SOLR",3,134,0.0440354912914887,201,12455,0.0223880597014925,0.0161380971497391,1.38728001782134,131,12254,0.821188123424298
"1716",1586,"IP REN HEMODIALYSIS/PUF",3043,"126580","HEPARIN, PORCINE (PF) 1,000 UNIT/ML INJ SOLN",7,807,0.26519881695695,58,653,0.00867410161090459,0.0888208269525268,0.0976584198607016,800,595,4.01548369440731e-13
"1717",1594,"IP SUR BARIATRIC SURGERY POSTOP",2248,"5002","METOCLOPRAMIDE HCL 5 MG/ML INJ SOLN",3,829,0.368772241992883,346,10128,0.00361881785283474,0.0341627172195893,0.105928864778931,826,9782,2.45344741474375e-06
"1718",1594,"IP SUR BARIATRIC SURGERY POSTOP",2248,"5007","METOPROLOL TARTRATE 5 MG/5 ML IV SOLN",2,279,0.124110320284698,745,12385,0.00716845878136201,0.0601534113847396,0.119169613432441,277,11640,0.000335278359126871
"1719",1594,"IP SUR BARIATRIC SURGERY POSTOP",2248,"14863","POTASSIUM CHLORID-D5-0.45%NACL 20 MEQ/L IV SOLP",2,560,0.249110320284698,314,8762,0.00357142857142857,0.035836566993837,0.0996587807097361,558,8448,7.18572219509831e-05
"1720",1594,"IP SUR BARIATRIC SURGERY POSTOP",2248,"15861","D5 %-0.45 % SODIUM CHLORIDE IV SOLP",1,11,0.0048932384341637,158,4300,0.0909090909090909,0.0367441860465116,2.4741081703107,10,4142,0.879944222901443
"1721",1594,"IP SUR BARIATRIC SURGERY POSTOP",2248,"16426","NS WITH POTASSIUM CHLORIDE 20 MEQ/L IV SOLP",1,76,0.0338078291814947,118,4415,0.0131578947368421,0.026727066817667,0.492305976806423,75,4297,0.711302620206601
"1722",1594,"IP SUR BARIATRIC SURGERY POSTOP",2248,"27838","SODIUM CHLORIDE 0.9 % 0.9 % IV SOLP",1,174,0.0774021352313167,692,19620,0.00574712643678161,0.0352701325178389,0.162945983655571,173,18928,0.0571377483112076
"1723",1594,"IP SUR BARIATRIC SURGERY POSTOP",2248,"82384","PANTOPRAZOLE 40 MG IV SOLR",8,810,0.360320284697509,688,12925,0.00987654320987654,0.0532301740812379,0.185544071202986,802,12237,7.67354631727913e-08
"1724",1594,"IP SUR BARIATRIC SURGERY POSTOP",2248,"110892","ENOXAPARIN 40 MG/0.4 ML SC SYRG",2,12,0.00533807829181495,499,13896,0.166666666666667,0.0359096142774899,4.64128256513026,10,13397,0.0979704173770042
"1725",1594,"IP SUR BARIATRIC SURGERY POSTOP",2248,"198509","ONDANSETRON HCL (PF) 4 MG/2 ML INJ SOLN",8,970,0.431494661921708,705,36939,0.00824742268041237,0.0190855193697718,0.432129853037947,962,36234,0.0196445934148457
"1726",1594,"IP SUR BARIATRIC SURGERY POSTOP",2248,"212945","HEPARIN, PORCINE (PF) 5,000 UNIT/0.5 ML INJ SOLN",5,823,0.366103202846975,452,13480,0.00607533414337789,0.0335311572700297,0.181184743921978,818,13028,2.17863758270411e-05
"1727",1594,"IP SUR BARIATRIC SURGERY POSTOP",2248,"541048","HYDROMORPHONE VARIABLE DOSE INJECTION",1,10,0.00444839857651246,104,5739,0.1,0.0181216239763025,5.51826923076923,9,5635,0.453179301393086
"1728",1598,"IP SUR MINIMALLY INVASIVE FOREGUT  POSTOP",272,"5002","METOCLOPRAMIDE HCL 5 MG/ML INJ SOLN",1,94,0.345588235294118,346,10128,0.0106382978723404,0.0341627172195893,0.311400811708277,93,9782,0.333263768616171
"1729",1598,"IP SUR MINIMALLY INVASIVE FOREGUT  POSTOP",272,"82384","PANTOPRAZOLE 40 MG IV SOLR",2,68,0.25,688,12925,0.0294117647058824,0.0532301740812379,0.552539329685363,66,12237,0.546850709768956
"1730",1598,"IP SUR MINIMALLY INVASIVE FOREGUT  POSTOP",272,"540300","MORPHINE INJECTABLE SYRINGE",1,17,0.0625,61,1002,0.0588235294117647,0.0608782435129741,0.966248794599807,16,941,0.999999999999999
"1731",1612,"IP REN CCPD CONT CYCLE PERITONEAL DIALYSIS",728,"500030","PERITONEAL DIALYSIS SOLUTION",5,75,0.103021978021978,4,20,0.0666666666666667,0.2,0.333333333333333,70,16,0.167746683137264
"1732",1628,"IP ENT MAXILLOFACIAL SURGERY POSTOP",1203,"3697","HYDRALAZINE 20 MG/ML INJ SOLN",2,136,0.113050706566916,537,15149,0.0147058823529412,0.0354478843488019,0.4148592397853,134,14612,0.283667996935446
"1733",1628,"IP ENT MAXILLOFACIAL SURGERY POSTOP",1203,"5002","METOCLOPRAMIDE HCL 5 MG/ML INJ SOLN",9,416,0.345802161263508,346,10128,0.0216346153846154,0.0341627172195893,0.633281458425967,407,9782,0.211396778766618
"1734",1628,"IP ENT MAXILLOFACIAL SURGERY POSTOP",1203,"5943","OXYMETAZOLINE 0.05 % NASAL SPRA",1,192,0.159600997506234,106,2713,0.00520833333333333,0.0390711389605603,0.133303852201258,191,2607,0.0271608282990777
"1735",1628,"IP ENT MAXILLOFACIAL SURGERY POSTOP",1203,"10372","LABETALOL 5 MG/ML IV SOLN",6,129,0.107231920199501,370,5898,0.0465116279069767,0.0627331298745337,0.7414204902577,123,5528,0.568959157773201
"1736",1628,"IP ENT MAXILLOFACIAL SURGERY POSTOP",1203,"10813","OXYCODONE 5 MG/5 ML PO SOLN",11,306,0.254364089775561,328,8370,0.0359477124183007,0.0391875746714456,0.917324246771879,295,8042,0.890954419664741
"1737",1628,"IP ENT MAXILLOFACIAL SURGERY POSTOP",1203,"14863","POTASSIUM CHLORID-D5-0.45%NACL 20 MEQ/L IV SOLP",16,310,0.257689110556941,314,8762,0.0516129032258065,0.035836566993837,1.44023012122457,294,8448,0.192326492571792
"1738",1628,"IP ENT MAXILLOFACIAL SURGERY POSTOP",1203,"15861","D5 %-0.45 % SODIUM CHLORIDE IV SOLP",3,46,0.0382377389858687,158,4300,0.0652173913043478,0.0367441860465116,1.77490368739681,43,4142,0.53221508538873
"1739",1628,"IP ENT MAXILLOFACIAL SURGERY POSTOP",1203,"16426","NS WITH POTASSIUM CHLORIDE 20 MEQ/L IV SOLP",1,39,0.0324189526184539,118,4415,0.0256410256410256,0.026727066817667,0.959365493263798,38,4297,0.999999999999994
"1740",1628,"IP ENT MAXILLOFACIAL SURGERY POSTOP",1203,"25365","CEFAZOLIN IN DEXTROSE (ISO-OS) 1 GRAM/50 ML IV PGBK",4,321,0.266832917705736,258,5335,0.0124610591900312,0.0483598875351453,0.257673452631071,317,5077,0.00457846789623891
"1741",1628,"IP ENT MAXILLOFACIAL SURGERY POSTOP",1203,"29676","SODIUM CHLORIDE 0.65 % NASAL SPRA",1,162,0.134663341645885,51,3278,0.00617283950617284,0.0155582672361196,0.396756233357541,161,3227,0.531390871604489
"1742",1628,"IP ENT MAXILLOFACIAL SURGERY POSTOP",1203,"112564","MORPHINE 2 MG/ML INJ SYRG",6,284,0.236076475477972,276,6156,0.0211267605633803,0.0448343079922027,0.471218616044091,278,5880,0.0782986161193152
"1743",1628,"IP ENT MAXILLOFACIAL SURGERY POSTOP",1203,"124216","VANCOMYCIN IN D5W 1 GRAM/200 ML IV PGBK",1,1,0.000831255195344971,1951,16917,1,0.115327776792576,8.67093798052281,0,14966,0.228617033124343
"1744",1628,"IP ENT MAXILLOFACIAL SURGERY POSTOP",1203,"198509","ONDANSETRON HCL (PF) 4 MG/2 ML INJ SOLN",9,439,0.364921030756442,705,36939,0.020501138952164,0.0190855193697718,1.07417244220424,430,36234,0.968061769445117
"1745",1632,"IP ORAL STEROID TAPERS",1405,"2322","DEXAMETHASONE 0.5 MG PO TABS",5,69,0.0491103202846975,3,154,0.072463768115942,0.0194805194805195,3.71980676328502,64,151,0.114770992385177
"1746",1632,"IP ORAL STEROID TAPERS",1405,"2323","DEXAMETHASONE 0.75 MG PO TABS",6,76,0.0540925266903915,1,70,0.0789473684210526,0.0142857142857143,5.52631578947368,70,69,0.150082290097862
"1747",1632,"IP ORAL STEROID TAPERS",1405,"2324","DEXAMETHASONE 1 MG PO TABS",100,3134,1,59,2074,0.0319081046585833,0.0284474445515911,1.12165100104918,3034,2015,0.529761860988916
"1748",1632,"IP ORAL STEROID TAPERS",1405,"2325","DEXAMETHASONE 1.5 MG PO TABS",33,1534,1,14,255,0.0215123859191656,0.0549019607843137,0.391832743527659,1501,241,0.00403373894585234
"1749",1632,"IP ORAL STEROID TAPERS",1405,"2326","DEXAMETHASONE 2 MG PO TABS",23,949,0.675444839857651,47,1734,0.0242360379346681,0.0271049596309112,0.894155101674775,926,1687,0.749673188618769
"1750",1632,"IP ORAL STEROID TAPERS",1405,"2327","DEXAMETHASONE 4 MG PO TABS",58,1096,0.780071174377224,277,6991,0.0529197080291971,0.0396223716206551,1.3356017286358,1038,6714,0.0485525371752012
"1751",1632,"IP ORAL STEROID TAPERS",1405,"6494","PREDNISONE 10 MG PO TABS",5,38,0.0270462633451957,104,4234,0.131578947368421,0.0245630609352858,5.35678137651822,33,4130,0.000263978387692845
"1752",1632,"IP ORAL STEROID TAPERS",1405,"6496","PREDNISONE 20 MG PO TABS",4,81,0.0576512455516014,276,7517,0.0493827160493827,0.0367167753092989,1.34496332080873,77,7241,0.760088051446617
"1753",1632,"IP ORAL STEROID TAPERS",1405,"6497","PREDNISONE 5 MG PO TABS",1,37,0.0263345195729537,108,4678,0.027027027027027,0.023086789226165,1.17067067067067,36,4570,0.999999999999815
"1754",1632,"IP ORAL STEROID TAPERS",1405,"6498","PREDNISONE 50 MG PO TABS",1,19,0.0135231316725979,34,1011,0.0526315789473684,0.0336300692383778,1.56501547987616,18,977,0.999999999999989
"1755",1632,"IP ORAL STEROID TAPERS",1405,"14887","METHYLPREDNISOLONE 4 MG PO DSPK",47,659,0.469039145907473,93,1087,0.0713201820940819,0.0855565777368905,0.833602558454485,612,994,0.331595638318061
"1756",1632,"IP ORAL STEROID TAPERS",1405,"9000000","ZZZ IMS TEMPLATE",6,91,0.0647686832740214,1035,28824,0.0659340659340659,0.0359075770191507,1.83621595795509,85,27789,0.210091478332606
"1757",1635,"NURSING TRIAGE PNEUMONIA PROTOCOL",62,"101","ACETAMINOPHEN 325 MG PO TABS",3,7,0.112903225806452,981,42092,0.428571428571429,0.0233060914187969,18.3888160768895,4,41111,5.05701134475349e-09
"1758",1637,"NURSING TRIAGE ASTHMA PROTOCOL",28,"250","ALBUTEROL SULFATE 2.5 MG /3 ML (0.083 %) INH NEBU",3,7,0.25,106,3939,0.428571428571429,0.0269103833460269,15.9258760107817,4,3833,1.01330953657042e-07
"1759",1637,"NURSING TRIAGE ASTHMA PROTOCOL",28,"12580","IPRATROPIUM BROMIDE 0.02 % INH SOLN",1,7,0.25,127,3899,0.142857142857143,0.0325724544755065,4.38582677165354,6,3772,0.56528085366827
"1760",1644,"IP NSR PITUITARY POSTOP ",777,"3697","HYDRALAZINE 20 MG/ML INJ SOLN",1,95,0.122265122265122,537,15149,0.0105263157894737,0.0354478843488019,0.296951876898951,94,14612,0.301400037305725
"1761",1644,"IP NSR PITUITARY POSTOP ",777,"5373","NALOXONE 0.4 MG/ML INJ SOLN",6,216,0.277992277992278,83,1774,0.0277777777777778,0.0467869222096956,0.593708165997323,210,1691,0.270531398853502
"1762",1644,"IP NSR PITUITARY POSTOP ",777,"10055","FLUMAZENIL 0.1 MG/ML IV SOLN",5,210,0.27027027027027,14,238,0.0238095238095238,0.0588235294117647,0.404761904761905,205,224,0.109541391797849
"1763",1644,"IP NSR PITUITARY POSTOP ",777,"16426","NS WITH POTASSIUM CHLORIDE 20 MEQ/L IV SOLP",1,155,0.199485199485199,118,4415,0.00645161290322581,0.026727066817667,0.241388737014762,154,4297,0.193124390092768
"1764",1644,"IP NSR PITUITARY POSTOP ",777,"28384","HYDROCODONE-ACETAMINOPHEN 10-325 MG PO TABS",1,33,0.0424710424710425,335,9576,0.0303030303030303,0.0349832915622389,0.866214382632293,32,9241,0.999999999999972
"1765",1644,"IP NSR PITUITARY POSTOP ",777,"34505","HYDROCODONE-ACETAMINOPHEN 5-325 MG PO TABS",7,217,0.279279279279279,603,24164,0.032258064516129,0.0249544777354743,1.29267640293158,210,23561,0.640149992244382
"1766",1644,"IP NSR PITUITARY POSTOP ",777,"198509","ONDANSETRON HCL (PF) 4 MG/2 ML INJ SOLN",2,195,0.250965250965251,705,36939,0.0102564102564103,0.0190855193697718,0.537392253136934,193,36234,0.524060734882241
"1767",1644,"IP NSR PITUITARY POSTOP ",777,"210379","HYDROCORTISONE SOD SUCC (PF) 100 MG/2 ML INJ SOLR",2,58,0.0746460746460746,313,9164,0.0344827586206897,0.0341553906591008,1.00958466453674,56,8851,0.999999999999543
"1768",1644,"IP NSR PITUITARY POSTOP ",777,"540106","FENTANYL (PF) 50 MCG/ML INJECTION",3,193,0.248391248391248,461,18637,0.0155440414507772,0.0247357407308043,0.628404122598991,190,18176,0.557811442544071
"1769",1651,"IP CTS CARDIAC SURGERY ADMISSION",3389,"101","ACETAMINOPHEN 325 MG PO TABS",28,1012,0.298613160224255,981,42092,0.0276679841897233,0.0233060914187969,1.18715676912725,984,41111,0.422719367519552
"1770",1651,"IP CTS CARDIAC SURGERY ADMISSION",3389,"680","ASPIRIN 81 MG PO CHEW",1,23,0.00678666273236943,357,11203,0.0434782608695652,0.031866464339909,1.36438923395445,22,10846,0.999999999999973
"1771",1651,"IP CTS CARDIAC SURGERY ADMISSION",3389,"1080","BISACODYL 10 MG PR SUPP",1,34,0.0100324579521983,344,22442,0.0294117647058824,0.0153284021031994,1.9187756497948,33,22098,0.999999999998974
"1772",1651,"IP CTS CARDIAC SURGERY ADMISSION",3389,"1445","CEFAZOLIN 1 GRAM INJ SOLR",53,564,0.166420773089407,47,571,0.0939716312056738,0.0823117338003503,1.1416553493285,511,524,0.556402308636085
"1773",1651,"IP CTS CARDIAC SURGERY ADMISSION",3389,"4711","MAGNESIUM CITRATE PO SOLN",1,32,0.00944231336677486,131,5481,0.03125,0.0239007480386791,1.30749045801527,31,5350,0.999999999999981
"1774",1651,"IP CTS CARDIAC SURGERY ADMISSION",3389,"7753","TEMAZEPAM 15 MG PO CAPS",1,40,0.0118028917084686,24,941,0.025,0.0255047821466525,0.980208333333333,39,917,0.999999999999956
"1775",1651,"IP CTS CARDIAC SURGERY ADMISSION",3389,"8442","VANCOMYCIN 1,000 MG IV SOLR",27,136,0.0401298318087932,248,2879,0.198529411764706,0.0861410211879125,2.30470232447818,109,2631,1.73823423691276e-05
"1776",1651,"IP CTS CARDIAC SURGERY ADMISSION",3389,"9516","CHLORHEXIDINE GLUCONATE 0.12 % MM MWSH",22,1218,0.359398052522868,89,4372,0.0180623973727422,0.0203568161024703,0.887289902400325,1196,4283,0.69543603720579
"1777",1651,"IP CTS CARDIAC SURGERY ADMISSION",3389,"13654","ASPIRIN 325 MG PO TBEC",1,1,0.000295072292711714,16,582,1,0.0274914089347079,36.375,0,566,0.00509757346214272
"1778",1651,"IP CTS CARDIAC SURGERY ADMISSION",3389,"14113","ASPIRIN 81 MG PO TBEC",1,15,0.00442608439067572,391,18448,0.0666666666666667,0.0211947094535993,3.14543904518329,14,18057,0.744981297783516
"1779",1651,"IP CTS CARDIAC SURGERY ADMISSION",3389,"14863","POTASSIUM CHLORID-D5-0.45%NACL 20 MEQ/L IV SOLP",1,8,0.00236057834169371,314,8762,0.125,0.035836566993837,3.48805732484076,7,8448,0.686049487184666
"1780",1651,"IP CTS CARDIAC SURGERY ADMISSION",3389,"34505","HYDROCODONE-ACETAMINOPHEN 5-325 MG PO TABS",1,28,0.008262024195928,603,24164,0.0357142857142857,0.0249544777354743,1.43117744610282,27,23561,0.999999999999994
"1781",1651,"IP CTS CARDIAC SURGERY ADMISSION",3389,"38285","ALUM-MAG HYDROXIDE-SIMETH 200-200-20 MG/5 ML PO SUSP",15,956,0.282089111832399,71,5546,0.0156903765690377,0.0128020194734944,1.22561730213919,941,5475,0.569563925095733
"1782",1651,"IP CTS CARDIAC SURGERY ADMISSION",3389,"124216","VANCOMYCIN IN D5W 1 GRAM/200 ML IV PGBK",2,41,0.0120979640011803,1951,16917,0.0487804878048781,0.115327776792576,0.422972584415747,39,14966,0.276458484219928
"1783",1651,"IP CTS CARDIAC SURGERY ADMISSION",3389,"200273","PEG 3350-ELECTROLYTES 236-22.74-6.74 -5.86 GRAM PO SOLR",7,17,0.00501622897609914,89,2251,0.411764705882353,0.039537983118614,10.4144084600132,10,2162,2.75855830941002e-12
"1784",1651,"IP CTS CARDIAC SURGERY ADMISSION",3389,"212945","HEPARIN, PORCINE (PF) 5,000 UNIT/0.5 ML INJ SOLN",1,5,0.00147536146355857,452,13480,0.2,0.0335311572700297,5.96460176991151,4,13028,0.40977862268031
"1785",1651,"IP CTS CARDIAC SURGERY ADMISSION",3389,"236263","CEFAZOLIN IN DEXTROSE (ISO-OS) 2 GRAM/100 ML IV PGBK",13,400,0.118028917084686,111,2584,0.0325,0.0429566563467492,0.756576576576577,387,2473,0.400605256386296
"1786",1651,"IP CTS CARDIAC SURGERY ADMISSION",3389,"520046","VANCOMYCIN IVPB (CUSTOM DOSE)",1,18,0.00531130126881086,1808,23328,0.0555555555555556,0.0775034293552812,0.716814159292035,17,21520,0.999999999999637
"1787",1651,"IP CTS CARDIAC SURGERY ADMISSION",3389,"541228","CEFAZOLIN IVPB (COMPOUNDED)",2,10,0.00295072292711714,10,117,0.2,0.0854700854700855,2.34,8,107,0.531802452773848
"1788",1652,"IP IV STEROID TAPERS",236,"2332","DEXAMETHASONE SODIUM PHOSPHATE 4 MG/ML INJ SOLN",51,1007,1,390,6737,0.0506454816285998,0.0578892682202761,0.874868230081736,956,6347,0.394055971883017
"1789",1652,"IP IV STEROID TAPERS",236,"6494","PREDNISONE 10 MG PO TABS",1,2,0.00847457627118644,104,4234,0.5,0.0245630609352858,20.3557692307692,1,4130,0.0404613232657077
"1790",1652,"IP IV STEROID TAPERS",236,"209508","METHYLPREDNISOLONE SOD SUC(PF) 40 MG/ML INJ SOLR",3,21,0.0889830508474576,155,3480,0.142857142857143,0.0445402298850575,3.2073732718894,18,3325,0.101700602359505
"1791",1652,"IP IV STEROID TAPERS",236,"209509","METHYLPREDNISOLONE SOD SUC(PF) 125 MG/2 ML INJ SOLR",9,42,0.177966101694915,275,8000,0.214285714285714,0.034375,6.23376623376623,33,7725,4.06811539464871e-09
"1792",1653,"IP TRS HEART TRANSPLANT POSTOP",1393,"464","AMPHOTERICIN B 50 MG INJ SOLR",1,71,0.0509691313711414,4,131,0.0140845070422535,0.0305343511450382,0.461267605633803,70,127,0.807097511279137
"1793",1653,"IP TRS HEART TRANSPLANT POSTOP",1393,"1080","BISACODYL 10 MG PR SUPP",4,198,0.142139267767408,344,22442,0.0202020202020202,0.0153284021031994,1.31794691097017,194,22098,0.791095313230563
"1794",1653,"IP TRS HEART TRANSPLANT POSTOP",1393,"2365","DEXTROSE 50 % IN WATER (D50W) IV SYRG",7,182,0.130653266331658,134,3551,0.0384615384615385,0.0377358490566038,1.01923076923077,175,3417,0.999999999999999
"1795",1653,"IP TRS HEART TRANSPLANT POSTOP",1393,"2508","DIPHENHYDRAMINE HCL 50 MG/ML INJ SOLN",4,167,0.119885139985642,399,16019,0.0239520958083832,0.0249079218428117,0.961625620938574,163,15620,0.999999999999651
"1796",1653,"IP TRS HEART TRANSPLANT POSTOP",1393,"2566","DOCUSATE SODIUM 100 MG PO CAPS",3,87,0.0624551328068916,542,37509,0.0344827586206897,0.0144498653656456,2.38637231199898,84,36967,0.265925346985864
"1797",1653,"IP TRS HEART TRANSPLANT POSTOP",1393,"5751","NYSTATIN 100,000 UNIT/ML PO SUSP",1,116,0.0832735104091888,68,4056,0.00862068965517241,0.0167652859960552,0.51419878296146,115,3988,0.757319016485468
"1798",1653,"IP TRS HEART TRANSPLANT POSTOP",1393,"6492","PREDNISONE 5 MG/5 ML PO SOLN",9,176,0.126346015793252,72,1096,0.0511363636363636,0.0656934306569343,0.778409090909091,167,1024,0.570128172395983
"1799",1653,"IP TRS HEART TRANSPLANT POSTOP",1393,"6496","PREDNISONE 20 MG PO TABS",1,40,0.0287150035893754,276,7517,0.025,0.0367167753092989,0.68088768115942,39,7241,0.999999999999998
"1800",1653,"IP TRS HEART TRANSPLANT POSTOP",1393,"7557","SULFAMETHOXAZOLE-TRIMETHOPRIM 400-80 MG PO TABS",7,140,0.100502512562814,112,3269,0.05,0.0342612419700214,1.459375,133,3157,0.448194315838588
"1801",1653,"IP TRS HEART TRANSPLANT POSTOP",1393,"9516","CHLORHEXIDINE GLUCONATE 0.12 % MM MWSH",7,181,0.129935391241924,89,4372,0.0386740331491713,0.0203568161024703,1.89980756099075,174,4283,0.156520542372094
"1802",1653,"IP TRS HEART TRANSPLANT POSTOP",1393,"11349","SENNOSIDES 8.6 MG PO TABS",1,146,0.10480976310122,610,35793,0.00684931506849315,0.0170424384656218,0.401897597125533,145,35183,0.528665367815338
"1803",1653,"IP TRS HEART TRANSPLANT POSTOP",1393,"25365","CEFAZOLIN IN DEXTROSE (ISO-OS) 1 GRAM/50 ML IV PGBK",3,25,0.0179468772433597,258,5335,0.12,0.0483598875351453,2.48139534883721,22,5077,0.232208286002477
"1804",1653,"IP TRS HEART TRANSPLANT POSTOP",1393,"82384","PANTOPRAZOLE 40 MG IV SOLR",3,47,0.0337401292175162,688,12925,0.0638297872340425,0.0532301740812379,1.19912790697674,44,12237,0.999999999999904
"1805",1653,"IP TRS HEART TRANSPLANT POSTOP",1393,"96559","PIPERACILLIN-TAZOBACTAM-DEXTRS 3.375 GRAM/50 ML IV PGBK",10,75,0.053840631730079,1067,10067,0.133333333333333,0.105989867885169,1.25798188066229,65,9000,0.563478190727038
"1806",1653,"IP TRS HEART TRANSPLANT POSTOP",1393,"124216","VANCOMYCIN IN D5W 1 GRAM/200 ML IV PGBK",13,164,0.117731514716439,1951,16917,0.0792682926829268,0.115327776792576,0.687330449675589,151,14966,0.187618408060115
"1807",1653,"IP TRS HEART TRANSPLANT POSTOP",1393,"124873","SENNA LEAF EXTRACT 176 MG/5 ML PO SYRP",2,102,0.0732232591529074,90,4112,0.0196078431372549,0.0218871595330739,0.895860566448802,100,4022,0.999999999999972
"1808",1653,"IP TRS HEART TRANSPLANT POSTOP",1393,"198509","ONDANSETRON HCL (PF) 4 MG/2 ML INJ SOLN",5,201,0.144292893036612,705,36939,0.0248756218905473,0.0190855193697718,1.3033767333545,196,36234,0.734158030233505
"1809",1653,"IP TRS HEART TRANSPLANT POSTOP",1393,"202606","FAMOTIDINE (PF) 20 MG/2 ML IV SOLN",4,101,0.072505384063173,288,4280,0.0396039603960396,0.0672897196261682,0.588558855885589,97,3992,0.367690783504833
"1810",1653,"IP TRS HEART TRANSPLANT POSTOP",1393,"205192","MILRINONE IN D5W 20 MG/100 ML IV PGBK",4,38,0.0272792534099067,27,851,0.105263157894737,0.0317273795534665,3.317738791423,34,824,0.0493349750467536
"1811",1653,"IP TRS HEART TRANSPLANT POSTOP",1393,"206169","DOPAMINE IN 5 % DEXTROSE 400 MG/250 ML (1,600 MCG/ML) IV SOLN",3,118,0.0847092605886576,62,1778,0.0254237288135593,0.0348706411698538,0.729086932750137,115,1716,0.775700890588419
"1812",1653,"IP TRS HEART TRANSPLANT POSTOP",1393,"209037","ACETAMINOPHEN 650 MG/20.3 ML PO SOLN",8,339,0.243359655419957,192,8611,0.023598820058997,0.0222970618975729,1.05838249754179,331,8419,0.999999999999994
"1813",1653,"IP TRS HEART TRANSPLANT POSTOP",1393,"209509","METHYLPREDNISOLONE SOD SUC(PF) 125 MG/2 ML INJ SOLR",3,189,0.135678391959799,275,8000,0.0158730158730159,0.034375,0.461760461760462,186,7725,0.235988842201653
"1814",1653,"IP TRS HEART TRANSPLANT POSTOP",1393,"210379","HYDROCORTISONE SOD SUCC (PF) 100 MG/2 ML INJ SOLR",7,127,0.091170136396267,313,9164,0.0551181102362205,0.0341553906591008,1.61374556614928,120,8851,0.297607710302788
"1815",1653,"IP TRS HEART TRANSPLANT POSTOP",1393,"226058","EPINEPHRINE HCL IN 0.9 % NACL 4 MG/250 ML (16 MCG/ML) IV SOLN",2,42,0.0301507537688442,56,1218,0.0476190476190476,0.0459770114942529,1.03571428571429,40,1162,0.999999999999964
"1816",1653,"IP TRS HEART TRANSPLANT POSTOP",1393,"520055","GANCICLOVIR IVPB",11,182,0.130653266331658,62,1312,0.0604395604395604,0.0472560975609756,1.2789790854307,171,1250,0.555414328972694
"1817",1653,"IP TRS HEART TRANSPLANT POSTOP",1393,"520073","MYCOPHENOLATE IVPB",2,89,0.0638908829863604,37,865,0.0224719101123595,0.0427745664739884,0.525356817491649,87,828,0.522193550845754
"1818",1653,"IP TRS HEART TRANSPLANT POSTOP",1393,"520074","ANTITHYMOCYTE GLOBULIN RABBIT IVPB",12,152,0.109117013639627,75,1781,0.0789473684210526,0.0421111734980348,1.87473684210526,140,1706,0.0575819754430648
"1819",1653,"IP TRS HEART TRANSPLANT POSTOP",1393,"530006","EPINEPHRINE IV INFUSION",3,120,0.0861450107681263,99,2540,0.025,0.0389763779527559,0.641414141414141,117,2441,0.59205594080498
"1820",1653,"IP TRS HEART TRANSPLANT POSTOP",1393,"530017","ISOPROTERENOL IV INFUSION",2,11,0.00789662598707825,4,147,0.181818181818182,0.0272108843537415,6.68181818181818,9,143,0.0767278479133054
"1821",1653,"IP TRS HEART TRANSPLANT POSTOP",1393,"530025","DEXMEDETOMIDINE IV INFUSION",2,8,0.00574300071787509,530,2902,0.25,0.18263266712612,1.3688679245283,6,2372,0.972630150069924
"1822",1653,"IP TRS HEART TRANSPLANT POSTOP",1393,"530049","INSULIN REGULAR 1 UNIT/ML IV INFUSION (NEW)",7,176,0.126346015793252,23,2672,0.0397727272727273,0.00860778443113772,4.62055335968379,169,2649,0.000397827426019971
"1823",1653,"IP TRS HEART TRANSPLANT POSTOP",1393,"540129","TACROLIMUS 1 MG/ML ORAL SUSPENSION",5,180,0.12921751615219,147,4881,0.0277777777777778,0.0301167793484942,0.922335600907029,175,4734,0.999999999999996
"1824",1653,"IP TRS HEART TRANSPLANT POSTOP",1393,"540321","MYCOPHENOLATE MOFETIL 200 MG/ML ORAL SUSP",5,109,0.0782483847810481,49,786,0.0458715596330275,0.0623409669211196,0.73581726268489,104,737,0.64400360664012
"1825",1653,"IP TRS HEART TRANSPLANT POSTOP",1393,"541271","PIPERACILLIN-TAZOBACTAM 3.375 GRAM/50 ML IVPB EXTENDED INFUSION",1,83,0.0595836324479541,466,8270,0.0120481927710843,0.0563482466747279,0.213816639950359,82,7804,0.131586168541194
"1826",1653,"IP TRS HEART TRANSPLANT POSTOP",1393,"541285","AMPHOTERICIN B 20 MG/4ML NEB SOLUTION",3,106,0.0760947595118449,2,126,0.0283018867924528,0.0158730158730159,1.78301886792453,103,124,0.844920083669902
"1827",1660,"IP GEN TPN/PPN  ADULT PROTOCOL",2935,"78963","FAT EMULSION 20 % IV EMUL",86,1312,0.447018739352641,242,20224,0.0655487804878049,0.0119659810126582,5.47792783712961,1226,19982,1.88309123946763e-52
"1828",1660,"IP GEN TPN/PPN  ADULT PROTOCOL",2935,"550000","TPN ADULT STANDARD",140,1113,0.379216354344123,779,15481,0.125786163522013,0.0503197467863833,2.49973760909407,973,14702,4.36879556441377e-26
"1829",1660,"IP GEN TPN/PPN  ADULT PROTOCOL",2935,"550001","PPN ADULT STANDARD",16,163,0.0555366269165247,104,921,0.098159509202454,0.112920738327904,0.869277961302501,147,817,0.675777446045014
"1830",1660,"IP GEN TPN/PPN  ADULT PROTOCOL",2935,"550002","TPN BMT",10,108,0.0367972742759796,155,3565,0.0925925925925926,0.0434782608695652,2.12962962962963,98,3410,0.0283871373905396
"1831",1665,"IP TRS KIDNEY DONOR PREOP",221,"5002","METOCLOPRAMIDE HCL 5 MG/ML INJ SOLN",1,5,0.0226244343891403,346,10128,0.2,0.0341627172195893,5.85433526011561,4,9782,0.418680009960003
"1832",1665,"IP TRS KIDNEY DONOR PREOP",221,"27838","SODIUM CHLORIDE 0.9 % 0.9 % IV SOLP",1,114,0.515837104072398,692,19620,0.0087719298245614,0.0352701325178389,0.248707027684819,113,18928,0.201457982947326
"1833",1665,"IP TRS KIDNEY DONOR PREOP",221,"198509","ONDANSETRON HCL (PF) 4 MG/2 ML INJ SOLN",1,11,0.0497737556561086,705,36939,0.0909090909090909,0.0190855193697718,4.76324951644101,10,36234,0.523209561272467
"1834",1665,"IP TRS KIDNEY DONOR PREOP",221,"212945","HEPARIN, PORCINE (PF) 5,000 UNIT/0.5 ML INJ SOLN",1,8,0.0361990950226244,452,13480,0.125,0.0335311572700297,3.72787610619469,7,13028,0.649770163706163
"1835",1667,"IP GYN  GENERAL ADMISSION",2898,"101","ACETAMINOPHEN 325 MG PO TABS",3,382,0.131815044858523,981,42092,0.00785340314136126,0.0233060914187969,0.336967833869702,379,41111,0.067582140783348
"1836",1667,"IP GYN  GENERAL ADMISSION",2898,"1080","BISACODYL 10 MG PR SUPP",1,105,0.036231884057971,344,22442,0.00952380952380952,0.0153284021031994,0.621317829457364,104,22098,0.932273959917987
"1837",1667,"IP GYN  GENERAL ADMISSION",2898,"2566","DOCUSATE SODIUM 100 MG PO CAPS",3,120,0.041407867494824,542,37509,0.025,0.0144498653656456,1.73011992619926,117,36967,0.559795294602241
"1838",1667,"IP GYN  GENERAL ADMISSION",2898,"2569","DOCUSATE SODIUM 50 MG/5 ML PO LIQD",2,172,0.0593512767425811,170,7328,0.0116279069767442,0.0231986899563319,0.501231190150479,170,7158,0.456635357723867
"1839",1667,"IP GYN  GENERAL ADMISSION",2898,"3843","IBUPROFEN 400 MG PO TABS",1,62,0.0213940648723257,148,4216,0.0161290322580645,0.0351043643263757,0.459459459459459,61,4068,0.645437203913096
"1840",1667,"IP GYN  GENERAL ADMISSION",2898,"3844","IBUPROFEN 600 MG PO TABS",1,125,0.0431331953071084,98,3745,0.008,0.0261682242990654,0.305714285714286,124,3647,0.32823557915257
"1841",1667,"IP GYN  GENERAL ADMISSION",2898,"4318","LACTATED RINGERS IV SOLP",4,508,0.175293305728088,135,4847,0.0078740157480315,0.0278522797606767,0.28270632837562,504,4712,0.0108480809526651
"1842",1667,"IP GYN  GENERAL ADMISSION",2898,"4573","LORAZEPAM 1 MG PO TABS",3,52,0.0179434092477571,337,8494,0.0576923076923077,0.0396750647515894,1.45412006391235,49,8157,0.758941524192599
"1843",1667,"IP GYN  GENERAL ADMISSION",2898,"5002","METOCLOPRAMIDE HCL 5 MG/ML INJ SOLN",4,412,0.142167011732229,346,10128,0.00970873786407767,0.0341627172195893,0.284191032044447,408,9782,0.0100150342679743
"1844",1667,"IP GYN  GENERAL ADMISSION",2898,"5005","METOCLOPRAMIDE HCL 10 MG PO TABS",2,39,0.0134575569358178,127,2872,0.0512820512820513,0.0442200557103064,1.15970119119725,37,2745,0.999999999999996
"1845",1667,"IP GYN  GENERAL ADMISSION",2898,"5006","METOCLOPRAMIDE HCL 5 MG PO TABS",1,52,0.0179434092477571,28,997,0.0192307692307692,0.0280842527582748,0.684752747252747,51,969,0.999999999999999
"1846",1667,"IP GYN  GENERAL ADMISSION",2898,"6618","PROMETHAZINE 25 MG/ML INJ SOLN",1,37,0.0127674258109041,289,5149,0.027027027027027,0.056127403379297,0.481529972879454,36,4860,0.682829714355745
"1847",1667,"IP GYN  GENERAL ADMISSION",2898,"10467","LORAZEPAM 2 MG/ML INJ SOLN",1,45,0.015527950310559,749,20621,0.0222222222222222,0.0363221958197954,0.611808337041982,44,19872,0.91540398067136
"1848",1667,"IP GYN  GENERAL ADMISSION",2898,"16426","NS WITH POTASSIUM CHLORIDE 20 MEQ/L IV SOLP",2,27,0.0093167701863354,118,4415,0.0740740740740741,0.026727066817667,2.7715003138732,25,4297,0.358869779142219
"1849",1667,"IP GYN  GENERAL ADMISSION",2898,"22472","KETOROLAC 15 MG/ML INJ SOLN",3,147,0.0507246376811594,215,5031,0.0204081632653061,0.0427350427350427,0.477551020408163,144,4816,0.262558910503654
"1850",1667,"IP GYN  GENERAL ADMISSION",2898,"25424","POLYETHYLENE GLYCOL 3350 17 GRAM PO PWPK",1,80,0.0276052449965493,712,36910,0.0125,0.0192901652668653,0.647998595505618,79,36198,0.972700770015304
"1851",1667,"IP GYN  GENERAL ADMISSION",2898,"27838","SODIUM CHLORIDE 0.9 % 0.9 % IV SOLP",1,132,0.0455486542443064,692,19620,0.00757575757575758,0.0352701325178389,0.214792433000525,131,18928,0.137225501556941
"1852",1667,"IP GYN  GENERAL ADMISSION",2898,"37637","METOPROLOL TARTRATE 50 MG PO TABS",2,4,0.00138026224982747,809,19725,0.5,0.0410139416983523,12.1909765142151,2,18916,0.00076859522863466
"1853",1667,"IP GYN  GENERAL ADMISSION",2898,"82384","PANTOPRAZOLE 40 MG IV SOLR",2,90,0.031055900621118,688,12925,0.0222222222222222,0.0532301740812379,0.417474160206718,88,12237,0.28359373425909
"1854",1667,"IP GYN  GENERAL ADMISSION",2898,"94176","ONDANSETRON 4 MG PO TBDL",1,80,0.0276052449965493,153,4277,0.0125,0.0357727379003975,0.349428104575163,79,4124,0.417168253271253
"1855",1667,"IP GYN  GENERAL ADMISSION",2898,"110872","HYDROMORPHONE 2 MG/ML INJ SYRG",7,219,0.0755693581780538,738,23934,0.0319634703196347,0.0308347956881424,1.03660392768311,212,23196,0.999999999999547
"1856",1667,"IP GYN  GENERAL ADMISSION",2898,"110892","ENOXAPARIN 40 MG/0.4 ML SC SYRG",12,259,0.0893719806763285,499,13896,0.0463320463320463,0.0359096142774899,1.2902407130864,247,13397,0.469789877789493
"1857",1667,"IP GYN  GENERAL ADMISSION",2898,"112564","MORPHINE 2 MG/ML INJ SYRG",1,25,0.00862663906142167,276,6156,0.04,0.0448343079922027,0.892173913043478,24,5880,0.999999999999999
"1858",1667,"IP GYN  GENERAL ADMISSION",2898,"112586","HYDROMORPHONE 1 MG/ML INJ SYRG",3,248,0.085576259489303,1219,33427,0.0120967741935484,0.036467526251234,0.331713593902988,245,32208,0.0608873827173452
"1859",1667,"IP GYN  GENERAL ADMISSION",2898,"198509","ONDANSETRON HCL (PF) 4 MG/2 ML INJ SOLN",11,700,0.241545893719807,705,36939,0.0157142857142857,0.0190855193697718,0.82336170212766,689,36234,0.612021660464862
"1860",1667,"IP GYN  GENERAL ADMISSION",2898,"202606","FAMOTIDINE (PF) 20 MG/2 ML IV SOLN",1,17,0.00586611456176674,288,4280,0.0588235294117647,0.0672897196261682,0.874183006535948,16,3992,0.999999999999928
"1861",1667,"IP GYN  GENERAL ADMISSION",2898,"221636","PROCHLORPERAZINE EDISYLATE 10 MG/2 ML (5 MG/ML) INJ SOLN",1,97,0.0334713595583161,177,6874,0.0103092783505155,0.0257491998836194,0.400372764866911,96,6697,0.526612165834081
"1862",1667,"IP GYN  GENERAL ADMISSION",2898,"540102","NS IV BOLUS",1,9,0.0031055900621118,2225,80957,0.111111111111111,0.0274837259285794,4.04279650436954,8,78732,0.606629709610948
"1863",1667,"IP GYN  GENERAL ADMISSION",2898,"540115","LACTATED RINGERS IV BOLUS",2,15,0.005175983436853,400,12941,0.133333333333333,0.0309095124024419,4.31366666666667,13,12541,0.123201424528627
"1864",1667,"IP GYN  GENERAL ADMISSION",2898,"540493","WARFARIN PER PHARMACY PROTOCOL",1,2,0.000690131124913734,218,6316,0.5,0.0345155161494617,14.4862385321101,1,6098,0.0958999965627139
"1865",1667,"IP GYN  GENERAL ADMISSION",2898,"541048","HYDROMORPHONE VARIABLE DOSE INJECTION",1,23,0.00793650793650794,104,5739,0.0434782608695652,0.0181216239763025,2.3992474916388,22,5635,0.899471566849783
"1866",1677,"IP NSR NEUROSURGERY ADMISSION/POST-OP",11718,"101","ACETAMINOPHEN 325 MG PO TABS",41,2755,0.235108380269671,981,42092,0.0148820326678766,0.0233060914187969,0.638546910352968,2714,41111,0.00503727187360037
"1867",1677,"IP NSR NEUROSURGERY ADMISSION/POST-OP",11718,"102","ACETAMINOPHEN 500 MG PO TABS",3,61,0.00520566649598908,392,15968,0.0491803278688525,0.0245490981963928,2.0033456005353,58,15576,0.40949635414139
"1868",1677,"IP NSR NEUROSURGERY ADMISSION/POST-OP",11718,"105","ACETAMINOPHEN 650 MG PR SUPP",4,405,0.0345622119815668,59,929,0.00987654320987654,0.0635091496232508,0.155513705796192,401,870,4.02860421269216e-05
"1869",1677,"IP NSR NEUROSURGERY ADMISSION/POST-OP",11718,"2327","DEXAMETHASONE 4 MG PO TABS",2,35,0.0029868578255675,277,6991,0.0571428571428571,0.0396223716206551,1.44218669417225,33,6714,0.923842459178569
"1870",1677,"IP NSR NEUROSURGERY ADMISSION/POST-OP",11718,"2332","DEXAMETHASONE SODIUM PHOSPHATE 4 MG/ML INJ SOLN",6,242,0.0206519883939239,390,6737,0.0247933884297521,0.0578892682202761,0.428289891926256,236,6347,0.0408440857662951
"1871",1677,"IP NSR NEUROSURGERY ADMISSION/POST-OP",11718,"2404","DIAZEPAM 2 MG PO TABS",2,53,0.00452295613585936,52,1512,0.0377358490566038,0.0343915343915344,1.09724238026125,51,1460,0.999999999999993
"1872",1677,"IP NSR NEUROSURGERY ADMISSION/POST-OP",11718,"2405","DIAZEPAM 5 MG PO TABS",11,1083,0.0924219150025602,152,5041,0.0101569713758079,0.0301527474707399,0.336850609904262,1072,4889,0.000312012822312252
"1873",1677,"IP NSR NEUROSURGERY ADMISSION/POST-OP",11718,"2566","DOCUSATE SODIUM 100 MG PO CAPS",35,2718,0.231950844854071,542,37509,0.0128771155261221,0.0144498653656456,0.891158166548553,2683,36967,0.560325568452843
"1874",1677,"IP NSR NEUROSURGERY ADMISSION/POST-OP",11718,"2567","DOCUSATE SODIUM 250 MG PO CAPS",15,957,0.0816692268305172,296,17760,0.0156739811912226,0.0166666666666667,0.940438871473354,942,17464,0.917000096794691
"1875",1677,"IP NSR NEUROSURGERY ADMISSION/POST-OP",11718,"3697","HYDRALAZINE 20 MG/ML INJ SOLN",15,2997,0.255760368663594,537,15149,0.005005005005005,0.0354478843488019,0.141193334861864,2982,14612,1.26889736008059e-18
"1876",1677,"IP NSR NEUROSURGERY ADMISSION/POST-OP",11718,"4711","MAGNESIUM CITRATE PO SOLN",1,458,0.0390851681174262,131,5481,0.00218340611353712,0.0239007480386791,0.0913530451015034,457,5350,0.00418626494838588
"1877",1677,"IP NSR NEUROSURGERY ADMISSION/POST-OP",11718,"5002","METOCLOPRAMIDE HCL 5 MG/ML INJ SOLN",38,3534,0.301587301587302,346,10128,0.010752688172043,0.0341627172195893,0.314749207533097,3496,9782,6.44913338639265e-13
"1878",1677,"IP NSR NEUROSURGERY ADMISSION/POST-OP",11718,"5007","METOPROLOL TARTRATE 5 MG/5 ML IV SOLN",30,2487,0.212237583205325,745,12385,0.0120627261761158,0.0601534113847396,0.2005327029412,2457,11640,1.14984333926097e-22
"1879",1677,"IP NSR NEUROSURGERY ADMISSION/POST-OP",11718,"5373","NALOXONE 0.4 MG/ML INJ SOLN",71,3702,0.315924219150026,83,1774,0.0191788222582388,0.0467869222096956,0.409918442001393,3631,1691,1.22772057139769e-08
"1880",1677,"IP NSR NEUROSURGERY ADMISSION/POST-OP",11718,"5940","OXYCODONE-ACETAMINOPHEN 5-325 MG PO TABS",5,573,0.0488991295442908,218,7862,0.0087260034904014,0.0277283134062579,0.314696511199705,568,7644,0.00925735937355009
"1881",1677,"IP NSR NEUROSURGERY ADMISSION/POST-OP",11718,"6432","POTASSIUM CHLORIDE 20 MEQ/15 ML PO LIQD",3,673,0.0574330090459123,425,8090,0.00445765230312036,0.0525339925834363,0.0848527226641028,670,7665,4.58214067051246e-08
"1882",1677,"IP NSR NEUROSURGERY ADMISSION/POST-OP",11718,"8958","BUTALBITAL-ACETAMINOPHEN-CAFF 50-325-40 MG PO TABS",1,70,0.00597371565113501,58,2595,0.0142857142857143,0.0223506743737958,0.639162561576355,69,2537,0.967352314946852
"1883",1677,"IP NSR NEUROSURGERY ADMISSION/POST-OP",11718,"10011","FAMOTIDINE 20 MG PO TABS",6,615,0.0524833589349718,472,16960,0.00975609756097561,0.0278301886792453,0.350558081852005,609,16488,0.00985792266244222
"1884",1677,"IP NSR NEUROSURGERY ADMISSION/POST-OP",11718,"10055","FLUMAZENIL 0.1 MG/ML IV SOLN",34,3693,0.31515616999488,14,238,0.00920660709450311,0.0588235294117647,0.156512320606553,3659,224,1.11117922007225e-10
"1885",1677,"IP NSR NEUROSURGERY ADMISSION/POST-OP",11718,"10814","OXYCODONE 5 MG PO TABS",6,577,0.0492404847243557,1478,56614,0.0103986135181976,0.0261066167379094,0.398313332692312,571,55136,0.0257628356754892
"1886",1677,"IP NSR NEUROSURGERY ADMISSION/POST-OP",11718,"11349","SENNOSIDES 8.6 MG PO TABS",59,4130,0.352449223416965,610,35793,0.0142857142857143,0.0170424384656218,0.838243559718969,4071,35183,0.213930290275971
"1887",1677,"IP NSR NEUROSURGERY ADMISSION/POST-OP",11718,"16426","NS WITH POTASSIUM CHLORIDE 20 MEQ/L IV SOLP",25,2729,0.232889571599249,118,4415,0.00916086478563576,0.026727066817667,0.342756084987982,2704,4297,4.1100841647006e-07
"1888",1677,"IP NSR NEUROSURGERY ADMISSION/POST-OP",11718,"18308","GABAPENTIN 300 MG PO CAPS",1,48,0.00409626216077829,588,19458,0.0208333333333333,0.0302189330866482,0.689413265306122,47,18870,0.999999999999994
"1889",1677,"IP NSR NEUROSURGERY ADMISSION/POST-OP",11718,"25365","CEFAZOLIN IN DEXTROSE (ISO-OS) 1 GRAM/50 ML IV PGBK",14,873,0.0745007680491551,258,5335,0.0160366552119129,0.0483598875351453,0.33161068044789,859,5077,2.27245599006582e-05
"1890",1677,"IP NSR NEUROSURGERY ADMISSION/POST-OP",11718,"25424","POLYETHYLENE GLYCOL 3350 17 GRAM PO PWPK",11,1537,0.131165727939921,712,36910,0.00715679895901106,0.0192901652668653,0.371007653900419,1526,36198,0.000851904844664665
"1891",1677,"IP NSR NEUROSURGERY ADMISSION/POST-OP",11718,"27838","SODIUM CHLORIDE 0.9 % 0.9 % IV SOLP",2,221,0.0188598736985834,692,19620,0.00904977375565611,0.0352701325178389,0.256584625846782,219,18928,0.0541443366413855
"1892",1677,"IP NSR NEUROSURGERY ADMISSION/POST-OP",11718,"28384","HYDROCODONE-ACETAMINOPHEN 10-325 MG PO TABS",8,702,0.0599078341013825,335,9576,0.0113960113960114,0.0349832915622389,0.325755836203597,694,9241,0.00115496764254581
"1893",1677,"IP NSR NEUROSURGERY ADMISSION/POST-OP",11718,"30450","FAMOTIDINE(PF) IN SAL (ISO-OS) 20 MG/50 ML IV PGBK",1,56,0.004778972520908,35,839,0.0178571428571429,0.0417163289630513,0.428061224489796,55,804,0.597083692744417
"1894",1677,"IP NSR NEUROSURGERY ADMISSION/POST-OP",11718,"34505","HYDROCODONE-ACETAMINOPHEN 5-325 MG PO TABS",34,2129,0.18168629458952,603,24164,0.0159699389384688,0.0249544777354743,0.639962859882519,2095,23561,0.0120299713035686
"1895",1677,"IP NSR NEUROSURGERY ADMISSION/POST-OP",11718,"81934","NIMODIPINE 30 MG PO CAPS",1,7,0.000597371565113501,23,372,0.142857142857143,0.0618279569892473,2.31055900621118,6,349,0.929191308179688
"1896",1677,"IP NSR NEUROSURGERY ADMISSION/POST-OP",11718,"82384","PANTOPRAZOLE 40 MG IV SOLR",5,77,0.00657108721624851,688,12925,0.0649350649350649,0.0532301740812379,1.21989202657807,72,12237,0.840333046841788
"1897",1677,"IP NSR NEUROSURGERY ADMISSION/POST-OP",11718,"87473","CARBOXYMETHYLCELLULOSE SODIUM 0.5 % OPHT DROP",1,476,0.040621266427718,6,455,0.00210084033613445,0.0131868131868132,0.159313725490196,475,449,0.114593293675995
"1898",1677,"IP NSR NEUROSURGERY ADMISSION/POST-OP",11718,"88043","PANTOPRAZOLE 40 MG PO TBEC",2,206,0.0175797917733402,624,31884,0.00970873786407767,0.0195709446744449,0.496079163554892,204,31260,0.442786757001597
"1899",1677,"IP NSR NEUROSURGERY ADMISSION/POST-OP",11718,"93305","SCOPOLAMINE BASE 1.5 MG (1 MG OVER 3 DAYS) TD PT3D",22,1004,0.0856801501962792,93,5289,0.0219123505976096,0.0175836642087351,1.24617658398663,982,5196,0.417781457498066
"1900",1677,"IP NSR NEUROSURGERY ADMISSION/POST-OP",11718,"110872","HYDROMORPHONE 2 MG/ML INJ SYRG",14,587,0.0500938726745178,738,23934,0.0238500851788756,0.0308347956881424,0.773479591695406,573,23196,0.396143142423579
"1901",1677,"IP NSR NEUROSURGERY ADMISSION/POST-OP",11718,"110888","ENOXAPARIN 30 MG/0.3 ML SC SYRG",1,8,0.000682710360129715,73,1394,0.125,0.0523672883787661,2.38698630136986,7,1321,0.90188164607657
"1902",1677,"IP NSR NEUROSURGERY ADMISSION/POST-OP",11718,"110892","ENOXAPARIN 40 MG/0.4 ML SC SYRG",2,484,0.0413039767878478,499,13896,0.00413223140495868,0.0359096142774899,0.115073121449511,482,13397,0.000292739548466053
"1903",1677,"IP NSR NEUROSURGERY ADMISSION/POST-OP",11718,"112586","HYDROMORPHONE 1 MG/ML INJ SYRG",10,517,0.0441201570233828,1219,33427,0.0193423597678917,0.036467526251234,0.530399556982211,507,32208,0.0511878139345419
"1904",1677,"IP NSR NEUROSURGERY ADMISSION/POST-OP",11718,"124216","VANCOMYCIN IN D5W 1 GRAM/200 ML IV PGBK",4,138,0.0117767537122376,1951,16917,0.0289855072463768,0.115327776792576,0.251331535667328,134,14966,0.00239106640202645
"1905",1677,"IP NSR NEUROSURGERY ADMISSION/POST-OP",11718,"126992","LIDOCAINE (PF) 10 MG/ML (1 %) INJ SOLN",7,1145,0.0977129202935655,457,11068,0.00611353711790393,0.0412902059992772,0.148062645122452,1138,10611,5.03746372104995e-09
"1906",1677,"IP NSR NEUROSURGERY ADMISSION/POST-OP",11718,"198509","ONDANSETRON HCL (PF) 4 MG/2 ML INJ SOLN",37,3796,0.32394606588155,705,36939,0.00974710221285564,0.0190855193697718,0.510706678922942,3759,36234,5.49988752412626e-05
"1907",1677,"IP NSR NEUROSURGERY ADMISSION/POST-OP",11718,"202606","FAMOTIDINE (PF) 20 MG/2 ML IV SOLN",178,2239,0.191073562041304,288,4280,0.0794997766860205,0.0672897196261682,1.18145501463947,2061,3992,0.0773152057363409
"1908",1677,"IP NSR NEUROSURGERY ADMISSION/POST-OP",11718,"212629","ACETAMINOPHEN 1,000 MG/100 ML (10 MG/ML) IV SOLN",5,583,0.049752517494453,510,18335,0.00857632933104631,0.0278156531224434,0.308327447617126,578,17825,0.00733913001907508
"1909",1677,"IP NSR NEUROSURGERY ADMISSION/POST-OP",11718,"212945","HEPARIN, PORCINE (PF) 5,000 UNIT/0.5 ML INJ SOLN",3,243,0.0207373271889401,452,13480,0.0123456790123457,0.0335311572700297,0.368185294438982,240,13028,0.0994847076367003
"1910",1677,"IP NSR NEUROSURGERY ADMISSION/POST-OP",11718,"222567","LEVETIRACETAM IN NACL (ISO-OS) 500 MG/100 ML IV PGBK",1,16,0.00136542072025943,50,1098,0.0625,0.0455373406193078,1.3725,15,1048,0.999999999999998
"1911",1677,"IP NSR NEUROSURGERY ADMISSION/POST-OP",11718,"236263","CEFAZOLIN IN DEXTROSE (ISO-OS) 2 GRAM/100 ML IV PGBK",3,346,0.0295272230756102,111,2584,0.00867052023121387,0.0429566563467492,0.201843461959069,343,2473,0.00318627503392502
"1912",1677,"IP NSR NEUROSURGERY ADMISSION/POST-OP",11718,"520064","CEFAZOLIN 2 G IVPB",2,279,0.0238095238095238,109,2674,0.00716845878136201,0.0407629020194465,0.175857420012495,277,2565,0.00824090532791913
"1913",1677,"IP NSR NEUROSURGERY ADMISSION/POST-OP",11718,"520068","PHENYTOIN IVPB (500 MG OR LESS)",1,4,0.000341355180064858,153,533,0.25,0.287054409005629,0.870915032679739,3,380,0.99999999999998
"1914",1677,"IP NSR NEUROSURGERY ADMISSION/POST-OP",11718,"520301","CEFTRIAXONE 1 GRAM/50 ML NS IVPB",7,550,0.0469363372589179,3,146,0.0127272727272727,0.0205479452054795,0.619393939393939,543,143,0.752964089521779
"1915",1677,"IP NSR NEUROSURGERY ADMISSION/POST-OP",11718,"540106","FENTANYL (PF) 50 MCG/ML INJECTION",8,1171,0.099931728963987,461,18637,0.00683176771989752,0.0247357407308043,0.276190140988569,1163,18176,0.000139175256136937
"1916",1677,"IP NSR NEUROSURGERY ADMISSION/POST-OP",11718,"540301","POTASSIUM CHLORIDE ORAL SCALE",8,1106,0.0943847072879331,105,3653,0.00723327305605787,0.0287434984943882,0.251649014035994,1098,3548,6.23400195873438e-05
"1917",1677,"IP NSR NEUROSURGERY ADMISSION/POST-OP",11718,"540302","POTASSIUM CHLORIDE IV SCALE",7,1112,0.0948967400580304,150,4660,0.00629496402877698,0.0321888412017167,0.195563549160671,1105,4510,3.05626428664881e-06
"1918",1677,"IP NSR NEUROSURGERY ADMISSION/POST-OP",11718,"541048","HYDROMORPHONE VARIABLE DOSE INJECTION",3,122,0.0104113329919782,104,5739,0.0245901639344262,0.0181216239763025,1.35695145018916,119,5635,0.852138581297455
"1919",1687,"IP VAS ANGIO POST- CATH",462,"1080","BISACODYL 10 MG PR SUPP",2,89,0.192640692640693,344,22442,0.0224719101123595,0.0153284021031994,1.46603083355108,87,22098,0.908364940240793
"1920",1687,"IP VAS ANGIO POST- CATH",462,"2566","DOCUSATE SODIUM 100 MG PO CAPS",1,94,0.203463203463203,542,37509,0.0106382978723404,0.0144498653656456,0.736221245191175,93,36967,0.999999999999979
"1921",1687,"IP VAS ANGIO POST- CATH",462,"2567","DOCUSATE SODIUM 250 MG PO CAPS",2,32,0.0692640692640693,296,17760,0.0625,0.0166666666666667,3.75,30,17464,0.183794454853095
"1922",1687,"IP VAS ANGIO POST- CATH",462,"4318","LACTATED RINGERS IV SOLP",3,46,0.0995670995670996,135,4847,0.0652173913043478,0.0278522797606767,2.34154589371981,43,4712,0.281866675149382
"1923",1687,"IP VAS ANGIO POST- CATH",462,"5002","METOCLOPRAMIDE HCL 5 MG/ML INJ SOLN",1,115,0.248917748917749,346,10128,0.00869565217391304,0.0341627172195893,0.2545363156572,114,9782,0.214268164033043
"1924",1687,"IP VAS ANGIO POST- CATH",462,"5373","NALOXONE 0.4 MG/ML INJ SOLN",1,135,0.292207792207792,83,1774,0.00740740740740741,0.0467869222096956,0.158322177599286,134,1691,0.0532510541436137
"1925",1687,"IP VAS ANGIO POST- CATH",462,"11349","SENNOSIDES 8.6 MG PO TABS",2,127,0.274891774891775,610,35793,0.015748031496063,0.0170424384656218,0.92404801858784,125,35183,0.999999999999337
"1926",1687,"IP VAS ANGIO POST- CATH",462,"25365","CEFAZOLIN IN DEXTROSE (ISO-OS) 1 GRAM/50 ML IV PGBK",1,14,0.0303030303030303,258,5335,0.0714285714285714,0.0483598875351453,1.47702104097453,13,5077,0.999999999999558
"1927",1687,"IP VAS ANGIO POST- CATH",462,"86533","MAGNESIUM HYDROXIDE 400 MG/5 ML PO SUSP",1,91,0.196969696969697,111,6618,0.010989010989011,0.0167724388032638,0.655182655182655,90,6507,0.987411101440567
"1928",1687,"IP VAS ANGIO POST- CATH",462,"110872","HYDROMORPHONE 2 MG/ML INJ SYRG",1,50,0.108225108225108,738,23934,0.02,0.0308347956881424,0.648617886178862,49,23196,0.973460051416947
"1929",1687,"IP VAS ANGIO POST- CATH",462,"110892","ENOXAPARIN 40 MG/0.4 ML SC SYRG",1,2,0.00432900432900433,499,13896,0.5,0.0359096142774899,13.9238476953908,1,13397,0.10408135842914
"1930",1687,"IP VAS ANGIO POST- CATH",462,"112586","HYDROMORPHONE 1 MG/ML INJ SYRG",1,24,0.051948051948052,1219,33427,0.0416666666666667,0.036467526251234,1.14256904566585,23,32208,0.999999999999907
"1931",1687,"IP VAS ANGIO POST- CATH",462,"115141","ESMOLOL IN NACL (ISO-OSM) 2,000 MG/100 ML IV SOLP",1,1,0.00216450216450216,1,114,1,0.0087719298245614,114,0,113,0.000208934116823056
"1932",1687,"IP VAS ANGIO POST- CATH",462,"198509","ONDANSETRON HCL (PF) 4 MG/2 ML INJ SOLN",2,138,0.298701298701299,705,36939,0.0144927536231884,0.0190855193697718,0.759358618563059,136,36234,0.934674342676417
"1933",1687,"IP VAS ANGIO POST- CATH",462,"530040","ALTEPLASE INFUSION",1,20,0.0432900432900433,22,207,0.05,0.106280193236715,0.470454545454545,19,185,0.682900001968871
"1934",1687,"IP VAS ANGIO POST- CATH",462,"541085","CEFTRIAXONE 1 GRAM/50 ML MINI-BAG PLUS",1,3,0.00649350649350649,411,7130,0.333333333333333,0.0576437587657784,5.78264395782644,2,6719,0.418658985621735
"1935",1705,"IP REN CONTINUOUS RENAL REPLACEMENT THERAPY(CRRT)",6335,"94623","ALTEPLASE 2 MG INJ SOLR",2,115,0.0181531176006314,201,12455,0.0173913043478261,0.0161380971497391,1.07765520224962,113,12254,0.999999999999579
"1936",1705,"IP REN CONTINUOUS RENAL REPLACEMENT THERAPY(CRRT)",6335,"96471","CITRATE DEXTROSE SOLUTION MISC SOLN",25,1010,0.159431728492502,3,75,0.0247524752475248,0.04,0.618811881188119,985,72,0.670033836355298
"1937",1705,"IP REN CONTINUOUS RENAL REPLACEMENT THERAPY(CRRT)",6335,"126580","HEPARIN, PORCINE (PF) 1,000 UNIT/ML INJ SOLN",19,519,0.0819258089976322,58,653,0.0366088631984586,0.0888208269525268,0.412165304630922,500,595,0.000530349445720894
"1938",1705,"IP REN CONTINUOUS RENAL REPLACEMENT THERAPY(CRRT)",6335,"205894","PRISMASOL SOLUTION (BGK 2/0) (32 MEQ BICARB/L)",50,1542,0.243409629044988,4,19,0.0324254215304799,0.210526315789474,0.15402075226978,1492,15,0.0003299145056225
"1939",1705,"IP REN CONTINUOUS RENAL REPLACEMENT THERAPY(CRRT)",6335,"210698","BICARB DIALYS SOLN #15 W-O CA K (4 MEQ/L) -MG (1.2 MEQ/L) HEMODIAL SOLN",62,2050,0.323599052880821,4,19,0.0302439024390244,0.210526315789474,0.143658536585366,1988,15,0.00014739498307499
"1940",1705,"IP REN CONTINUOUS RENAL REPLACEMENT THERAPY(CRRT)",6335,"211166","BICARB DIALY SOLN W-O CA NO.16 K (4 MEQ/L) -MG (1.5 MEQ/L) HEMODIAL SOLN",41,1375,0.217048145224941,2,20,0.0298181818181818,0.1,0.298181818181818,1334,18,0.249612536766091
"1941",1705,"IP REN CONTINUOUS RENAL REPLACEMENT THERAPY(CRRT)",6335,"230501","DEXTROSE-SOD CITRATE-CITRIC AC 2.45-2.2 GRAM- 730 MG/100 ML MISC SOLN",7,391,0.0617205998421468,2,37,0.0179028132992327,0.0540540540540541,0.331202046035806,384,35,0.386769024639731
"1942",1705,"IP REN CONTINUOUS RENAL REPLACEMENT THERAPY(CRRT)",6335,"500006","SODIUM PHOSPHATE IVPB",134,2821,0.445303867403315,296,4785,0.0475008862105636,0.0618599791013584,0.767877501748469,2687,4489,0.0102337146106378
"1943",1705,"IP REN CONTINUOUS RENAL REPLACEMENT THERAPY(CRRT)",6335,"500034","CALCIUM CHLORIDE 8 G/1000 ML NS IV INFUSION",285,669,0.105603788476717,9,166,0.426008968609865,0.0542168674698795,7.85749875435974,384,157,6.31375959309468e-19
"1944",1705,"IP REN CONTINUOUS RENAL REPLACEMENT THERAPY(CRRT)",6335,"540911","CALCIUM GLUCONATE 107.6 MEQ NS 1,000 ML (CRRT)",98,638,0.100710339384373,10,519,0.153605015673981,0.0192678227360308,7.97210031347962,540,509,1.25506487926645e-14
"1945",1705,"IP REN CONTINUOUS RENAL REPLACEMENT THERAPY(CRRT)",6335,"541063","SODIUM GLYCEROPHOSPHATE (GLYCOPHOS) IN NS IVPB (CRRT)",47,457,0.072138910812944,5,39,0.102844638949672,0.128205128205128,0.80218818380744,410,34,0.822781611787748
"1946",1706,"DRUG DESENSITIZATION PROTOCOL HIGH ALERT",113,"213662","EPINEPHRINE 1 MG/ML (1:1,000) (1ML) INJ SOLN",1,44,0.389380530973451,69,5047,0.0227272727272727,0.0136714880126808,1.66238471673254,43,4978,0.999999999999998
"1947",1706,"DRUG DESENSITIZATION PROTOCOL HIGH ALERT",113,"520186","DESENSITIZATION DRUG MIXTURE-HIGH ALERT MED",18,285,1,7,39,0.0631578947368421,0.179487179487179,0.35187969924812,267,32,0.0255197774977627
"1948",1706,"DRUG DESENSITIZATION PROTOCOL HIGH ALERT",113,"540138","DESENSITIZATION DRUG HELP ORDER",3,6,0.0530973451327434,6,38,0.5,0.157894736842105,3.16666666666667,3,32,0.165719194946547
"1949",1713,"IP CTS CARDIAC SURGERY TRANSFER",8978,"101","ACETAMINOPHEN 325 MG PO TABS",102,2726,0.303631098240143,981,42092,0.0374174614820249,0.0233060914187969,1.60547990693312,2624,41111,4.53127229301411e-06
"1950",1713,"IP CTS CARDIAC SURGERY TRANSFER",8978,"663","ASCORBIC ACID 250 MG PO TABS",26,1472,0.163956337714413,39,2351,0.0176630434782609,0.0165886856656742,1.06476449275362,1446,2312,0.903306413953408
"1951",1713,"IP CTS CARDIAC SURGERY TRANSFER",8978,"664","ASCORBIC ACID 500 MG PO TABS",17,889,0.0990198262419247,59,3135,0.0191226096737908,0.0188197767145136,1.01609120893787,872,3076,0.999999999999997
"1952",1713,"IP CTS CARDIAC SURGERY TRANSFER",8978,"680","ASPIRIN 81 MG PO CHEW",21,441,0.0491200712853642,357,11203,0.0476190476190476,0.031866464339909,1.49433106575964,420,10846,0.0902822725419434
"1953",1713,"IP CTS CARDIAC SURGERY TRANSFER",8978,"1080","BISACODYL 10 MG PR SUPP",24,2275,0.253397193138784,344,22442,0.0105494505494505,0.0153284021031994,0.688228980322004,2251,22098,0.0886424615097297
"1954",1713,"IP CTS CARDIAC SURGERY TRANSFER",8978,"2566","DOCUSATE SODIUM 100 MG PO CAPS",43,1624,0.180886611717532,542,37509,0.0264778325123153,0.0144498653656456,1.83239302528493,1581,36967,0.000141126267651831
"1955",1713,"IP CTS CARDIAC SURGERY TRANSFER",8978,"2567","DOCUSATE SODIUM 250 MG PO CAPS",11,416,0.0463354867453776,296,17760,0.0264423076923077,0.0166666666666667,1.58653846153846,405,17464,0.181215245732847
"1956",1713,"IP CTS CARDIAC SURGERY TRANSFER",8978,"5373","NALOXONE 0.4 MG/ML INJ SOLN",32,2203,0.245377589663622,83,1774,0.0145256468452111,0.0467869222096956,0.310463825342222,2171,1691,2.85075030351632e-09
"1957",1713,"IP CTS CARDIAC SURGERY TRANSFER",8978,"8084","TRAZODONE 150 MG PO TABS",1,2,0.000222766763198931,1,155,0.5,0.00645161290322581,77.5,1,154,0.00260188853700249
"1958",1713,"IP CTS CARDIAC SURGERY TRANSFER",8978,"8085","TRAZODONE 50 MG PO TABS",38,2317,0.258075295165961,334,11344,0.0164005179110919,0.0294428772919605,0.557028368812655,2279,11010,0.000571128408784577
"1959",1713,"IP CTS CARDIAC SURGERY TRANSFER",8978,"10011","FAMOTIDINE 20 MG PO TABS",5,82,0.00913343729115616,472,16960,0.0609756097560976,0.0278301886792453,2.19098801157503,77,16488,0.138943468465541
"1960",1713,"IP CTS CARDIAC SURGERY TRANSFER",8978,"10055","FLUMAZENIL 0.1 MG/ML IV SOLN",26,1960,0.218311427934952,14,238,0.013265306122449,0.0588235294117647,0.225510204081633,1934,224,2.49563032520026e-06
"1961",1713,"IP CTS CARDIAC SURGERY TRANSFER",8978,"10813","OXYCODONE 5 MG/5 ML PO SOLN",1,6,0.000668300289596792,328,8370,0.166666666666667,0.0391875746714456,4.2530487804878,5,8042,0.578413987906119
"1962",1713,"IP CTS CARDIAC SURGERY TRANSFER",8978,"10814","OXYCODONE 5 MG PO TABS",55,2154,0.239919803965248,1478,56614,0.0255338904363974,0.0261066167379094,0.97806202514628,2099,55136,0.924459842962023
"1963",1713,"IP CTS CARDIAC SURGERY TRANSFER",8978,"11349","SENNOSIDES 8.6 MG PO TABS",56,2186,0.243484072176431,610,35793,0.0256175663311985,0.0170424384656218,1.50316319949605,2130,35183,0.003959392234265
"1964",1713,"IP CTS CARDIAC SURGERY TRANSFER",8978,"12580","IPRATROPIUM BROMIDE 0.02 % INH SOLN",44,1457,0.162285586990421,127,3899,0.0301990391214825,0.0325724544755065,0.927134279800475,1413,3772,0.724580691794922
"1965",1713,"IP CTS CARDIAC SURGERY TRANSFER",8978,"14113","ASPIRIN 81 MG PO TBEC",42,878,0.0977946090443306,391,18448,0.0478359908883827,0.0211947094535993,2.25697790258027,836,18057,3.49309940523784e-07
"1966",1713,"IP CTS CARDIAC SURGERY TRANSFER",8978,"14632","TRAMADOL 50 MG PO TABS",29,2328,0.259300512363555,304,13808,0.0124570446735395,0.0220162224797219,0.565812081750769,2299,13504,0.00347431260175956
"1967",1713,"IP CTS CARDIAC SURGERY TRANSFER",8978,"25424","POLYETHYLENE GLYCOL 3350 17 GRAM PO PWPK",46,2091,0.232902650924482,712,36910,0.021999043519847,0.0192901652668653,1.14042794426622,2045,36198,0.428661614041204
"1968",1713,"IP CTS CARDIAC SURGERY TRANSFER",8978,"28899","OXYCODONE 15 MG PO TABS",1,13,0.00144798396079305,51,1050,0.0769230769230769,0.0485714285714286,1.58371040723982,12,999,0.999999999999986
"1969",1713,"IP CTS CARDIAC SURGERY TRANSFER",8978,"35942","POTASSIUM CHLORIDE 10 MEQ PO TBTQ",1,103,0.0114724883047449,648,18469,0.00970873786407767,0.035085819481293,0.276714011746374,102,17821,0.258668115326521
"1970",1713,"IP CTS CARDIAC SURGERY TRANSFER",8978,"38285","ALUM-MAG HYDROXIDE-SIMETH 200-200-20 MG/5 ML PO SUSP",45,2302,0.256404544441969,71,5546,0.0195482189400521,0.0128020194734944,1.52696369354266,2257,5475,0.0313924094175265
"1971",1713,"IP CTS CARDIAC SURGERY TRANSFER",8978,"86533","MAGNESIUM HYDROXIDE 400 MG/5 ML PO SUSP",39,2284,0.254399643573179,111,6618,0.0170753064798599,0.0167724388032638,1.01805746201543,2245,6507,0.997853769617888
"1972",1713,"IP CTS CARDIAC SURGERY TRANSFER",8978,"87348","EPOETIN ALFA 40,000 UNIT/ML INJ SOLN",67,1200,0.133660057919358,19,641,0.0558333333333333,0.0296411856474259,1.88364035087719,1133,622,0.015471964813697
"1973",1713,"IP CTS CARDIAC SURGERY TRANSFER",8978,"88043","PANTOPRAZOLE 40 MG PO TBEC",48,1639,0.182557362441524,624,31884,0.0292861500915192,0.0195709446744449,1.49640963063782,1591,31260,0.00813466767890558
"1974",1713,"IP CTS CARDIAC SURGERY TRANSFER",8978,"110872","HYDROMORPHONE 2 MG/ML INJ SYRG",11,260,0.028959679215861,738,23934,0.0423076923076923,0.0308347956881424,1.37207629768605,249,23196,0.377603683454133
"1975",1713,"IP CTS CARDIAC SURGERY TRANSFER",8978,"111320","MULTIVITAMIN WITH IRON-MINERAL PO LIQD",1,11,0.00122521719759412,36,1196,0.0909090909090909,0.0301003344481605,3.02020202020202,10,1160,0.774830487294761
"1976",1713,"IP CTS CARDIAC SURGERY TRANSFER",8978,"112586","HYDROMORPHONE 1 MG/ML INJ SYRG",38,631,0.0702829137892626,1219,33427,0.0602218700475436,0.036467526251234,1.65138347012243,593,32208,0.0024543110120748
"1977",1713,"IP CTS CARDIAC SURGERY TRANSFER",8978,"198509","ONDANSETRON HCL (PF) 4 MG/2 ML INJ SOLN",55,2628,0.292715526843395,705,36939,0.0209284627092846,0.0190855193697718,1.09656238867839,2573,36234,0.554163926674737
"1978",1713,"IP CTS CARDIAC SURGERY TRANSFER",8978,"208037","FERROUS SULFATE 142 MG (45 MG IRON) PO TBSR",25,1016,0.113165515705057,13,984,0.0246062992125984,0.0132113821138211,1.86250757116899,991,971,0.088704775083491
"1979",1713,"IP CTS CARDIAC SURGERY TRANSFER",8978,"209036","ACETAMINOPHEN 325 MG/10.15 ML PO SOLN",1,14,0.00155936734239252,95,1460,0.0714285714285714,0.0650684931506849,1.09774436090226,13,1365,1
"1980",1713,"IP CTS CARDIAC SURGERY TRANSFER",8978,"212945","HEPARIN, PORCINE (PF) 5,000 UNIT/0.5 ML INJ SOLN",1,11,0.00122521719759412,452,13480,0.0909090909090909,0.0335311572700297,2.71118262268705,10,13028,0.826841950122822
"1981",1713,"IP CTS CARDIAC SURGERY TRANSFER",8978,"213228","FERROUS SULFATE 140 MG (45 MG IRON) PO TBSR",28,1263,0.140677210960125,14,999,0.0221694378463975,0.014014014014014,1.58194774346793,1235,985,0.204079331761425
"1982",1713,"IP CTS CARDIAC SURGERY TRANSFER",8978,"540106","FENTANYL (PF) 50 MCG/ML INJECTION",37,1399,0.155825350857652,461,18637,0.0264474624731951,0.0247357407308043,1.06920034297817,1362,18176,0.758389797090711
"1983",1713,"IP CTS CARDIAC SURGERY TRANSFER",8978,"540301","POTASSIUM CHLORIDE ORAL SCALE",46,2309,0.257184228113165,105,3653,0.0199220441749675,0.0287434984943882,0.693097403534822,2263,3548,0.0426395755168543
"1984",1713,"IP CTS CARDIAC SURGERY TRANSFER",8978,"540579","BENZOCAINE-MENTHOL SUGAR FREE MAXIMUM STRENGTH LOZG",19,2136,0.237914903096458,13,677,0.00889513108614232,0.0192023633677991,0.463231057332181,2117,664,0.0459642460900526
"1985",1713,"IP CTS CARDIAC SURGERY TRANSFER",8978,"540597","THERAPEUTIC MULTIVITAMIN (GENERIC) PO TABS",39,2303,0.256515927823569,106,7394,0.0169344333478072,0.0143359480659995,1.18125660541214,2264,7288,0.424349319575144
"1986",1716,"IP ATIC RITUXIMAB (RITUXAN)",28,"101","ACETAMINOPHEN 325 MG PO TABS",1,2,0.0714285714285714,981,42092,0.5,0.0233060914187969,21.453618756371,1,41111,0.0336916546422699
"1987",1716,"IP ATIC RITUXIMAB (RITUXAN)",28,"209509","METHYLPREDNISOLONE SOD SUC(PF) 125 MG/2 ML INJ SOLR",2,7,0.25,275,8000,0.285714285714286,0.034375,8.31168831168831,5,7725,0.00925230614654436
"1988",1716,"IP ATIC RITUXIMAB (RITUXAN)",28,"520000","RITUXIMAB IV STANDARD INFUSION",3,14,0.5,14,1252,0.214285714285714,0.0111821086261981,19.1632653061224,11,1238,6.72254757385862e-08
"1989",1717,"IP ATIC CYTOMEGALOVIRUS IMMUNE GLOBULIN (CYTOGAM)",3,"101","ACETAMINOPHEN 325 MG PO TABS",1,3,1,981,42092,0.333333333333333,0.0233060914187969,14.3024125042474,2,41111,0.100002477677862
"1990",1717,"IP ATIC CYTOMEGALOVIRUS IMMUNE GLOBULIN (CYTOGAM)",3,"2509","DIPHENHYDRAMINE HCL 25 MG PO CAPS",1,2,0.666666666666667,356,12049,0.5,0.0295460204166321,16.9227528089888,1,11693,0.0660143530444397
"1991",1724,"IP RESP INHALED MEDICATION NEBULIZER/MDI",1310,"122","ACETYLCYSTEINE 100 MG/ML (10 %) MISC SOLN",4,21,0.016030534351145,39,431,0.19047619047619,0.0904872389791183,2.10500610500611,17,392,0.252548476433774
"1992",1724,"IP RESP INHALED MEDICATION NEBULIZER/MDI",1310,"250","ALBUTEROL SULFATE 2.5 MG /3 ML (0.083 %) INH NEBU",5,154,0.117557251908397,106,3939,0.0324675324675325,0.0269103833460269,1.20650575839255,149,3833,0.870009244882793
"1993",1724,"IP RESP INHALED MEDICATION NEBULIZER/MDI",1310,"251","ALBUTEROL SULFATE 5 MG/ML INH NEBU",1,7,0.00534351145038168,100,358,0.142857142857143,0.279329608938547,0.511428571428571,6,258,0.709311338353464
"1994",1724,"IP RESP INHALED MEDICATION NEBULIZER/MDI",1310,"12580","IPRATROPIUM BROMIDE 0.02 % INH SOLN",1,74,0.0564885496183206,127,3899,0.0135135135135135,0.0325724544755065,0.414875505426687,73,3772,0.556847868196874
"1995",1724,"IP RESP INHALED MEDICATION NEBULIZER/MDI",1310,"78668","IPRATROPIUM-ALBUTEROL 0.5 MG-3 MG(2.5 MG BASE)/3 ML INH NEBU",12,386,0.294656488549618,493,18456,0.0310880829015544,0.0267121803207629,1.16381675057016,374,17963,0.713149495328523
"1996",1724,"IP RESP INHALED MEDICATION NEBULIZER/MDI",1310,"92642","LEVALBUTEROL HCL 1.25 MG/3 ML INH NEBU",2,39,0.0297709923664122,46,1262,0.0512820512820513,0.0364500792393027,1.40691192865106,37,1216,0.957967358926503
"1997",1724,"IP RESP INHALED MEDICATION NEBULIZER/MDI",1310,"225590","IPRATROPIUM-ALBUTEROL 20-100 MCG/ACTUATION INH AERO",3,6,0.00458015267175573,49,718,0.5,0.0682451253481894,7.3265306122449,3,669,0.00101923339490384
"1998",1729,"RETIRED IP ITA PHARM RITUXIMAB",58,"2327","DEXAMETHASONE 4 MG PO TABS",1,5,0.0862068965517241,277,6991,0.2,0.0396223716206551,5.04765342960289,4,6714,0.490144863674697
"1999",1729,"RETIRED IP ITA PHARM RITUXIMAB",58,"2327","DEXAMETHASONE 4 MG PO TABS",1,5,0.0862068965517241,277,6991,0.2,0.0396223716206551,5.04765342960289,4,6714,0.490144863674697
"2000",1729,"RETIRED IP ITA PHARM RITUXIMAB",58,"2508","DIPHENHYDRAMINE HCL 50 MG/ML INJ SOLN",1,41,0.706896551724138,399,16019,0.024390243902439,0.0249079218428117,0.979216333516719,40,15620,0.999999999999356
"2001",1729,"RETIRED IP ITA PHARM RITUXIMAB",58,"2508","DIPHENHYDRAMINE HCL 50 MG/ML INJ SOLN",1,41,0.706896551724138,399,16019,0.024390243902439,0.0249079218428117,0.979216333516719,40,15620,0.999999999999356
"2002",1729,"RETIRED IP ITA PHARM RITUXIMAB",58,"520000","RITUXIMAB IV STANDARD INFUSION",1,30,0.517241379310345,14,1252,0.0333333333333333,0.0111821086261981,2.98095238095238,29,1238,0.797977833102665
"2003",1729,"RETIRED IP ITA PHARM RITUXIMAB",58,"520000","RITUXIMAB IV STANDARD INFUSION",1,30,0.517241379310345,14,1252,0.0333333333333333,0.0111821086261981,2.98095238095238,29,1238,0.797977833102665
"2004",1729,"RETIRED IP ITA PHARM RITUXIMAB",58,"9000000","ZZZ IMS TEMPLATE",1,3,0.0517241379310345,1035,28824,0.333333333333333,0.0359075770191507,9.28309178743961,2,27789,0.223786333563954
"2005",1729,"RETIRED IP ITA PHARM RITUXIMAB",58,"9000000","ZZZ IMS TEMPLATE",1,3,0.0517241379310345,1035,28824,0.333333333333333,0.0359075770191507,9.28309178743961,2,27789,0.223786333563954
"2006",1742,"IP NUC I-131 THYROID THERAPY ADMISSION",50,"11138","PROCHLORPERAZINE 25 MG PR SUPP",2,8,0.16,6,140,0.25,0.0428571428571429,5.83333333333333,6,134,0.0861239795831721
"2007",1747,"RETIRED IP PAMF ORTHO TKA",144,"8751","WARFARIN 5 MG PO TABS",1,12,0.0833333333333333,131,4609,0.0833333333333333,0.0284226513343458,2.93193384223919,11,4478,0.785005273568251
"2008",1748,"RETIRED IP PAMF ORTHO THA",2288,"101","ACETAMINOPHEN 325 MG PO TABS",1,449,0.196241258741259,981,42092,0.0022271714922049,0.0233060914187969,0.0955617761976439,448,41111,0.00510020537562935
"2009",1748,"RETIRED IP PAMF ORTHO THA",2288,"102","ACETAMINOPHEN 500 MG PO TABS",1,225,0.0983391608391608,392,15968,0.00444444444444444,0.0245490981963928,0.181043083900227,224,15576,0.0840045859027544
"2010",1748,"RETIRED IP PAMF ORTHO THA",2288,"2508","DIPHENHYDRAMINE HCL 50 MG/ML INJ SOLN",5,1398,0.611013986013986,399,16019,0.00357653791130186,0.0249079218428117,0.143590377947731,1393,15620,6.0720780059539e-07
"2011",1748,"RETIRED IP PAMF ORTHO THA",2288,"2509","DIPHENHYDRAMINE HCL 25 MG PO CAPS",1,823,0.359702797202797,356,12049,0.00121506682867558,0.0295460204166321,0.0411245511761574,822,11693,2.88396956474914e-06
"2012",1748,"RETIRED IP PAMF ORTHO THA",2288,"3770","HYDROXYZINE HCL 50 MG/ML IM SOLN",91,516,0.225524475524476,18,59,0.176356589147287,0.305084745762712,0.578057708871662,425,41,0.0267988800228766
"2013",1748,"RETIRED IP PAMF ORTHO THA",2288,"6618","PROMETHAZINE 25 MG/ML INJ SOLN",1,802,0.350524475524476,289,5149,0.00124688279301746,0.056127403379297,0.0222152231877055,801,4860,3.44014265870588e-11
"2014",1748,"RETIRED IP PAMF ORTHO THA",2288,"7753","TEMAZEPAM 15 MG PO CAPS",1,172,0.0751748251748252,24,941,0.00581395348837209,0.0255047821466525,0.227955426356589,171,917,0.185954367135408
"2015",1748,"RETIRED IP PAMF ORTHO THA",2288,"10814","OXYCODONE 5 MG PO TABS",1,849,0.371066433566434,1478,56614,0.00117785630153121,0.0261066167379094,0.0451171560587876,848,55136,8.83865982595184e-06
"2016",1748,"RETIRED IP PAMF ORTHO THA",2288,"13410","ACETAMINOPHEN 650 MG PO TBSR",4,15,0.00655594405594406,8,179,0.266666666666667,0.0446927374301676,5.96666666666667,11,171,0.00410291235049868
"2017",1748,"RETIRED IP PAMF ORTHO THA",2288,"14858","D5-NS WITH POTASSIUM CHLORIDE 20 MEQ/L IV SOLP",3,546,0.238636363636364,58,2031,0.00549450549450549,0.0285573609059577,0.192402425161046,543,1973,0.00280367154534546
"2018",1748,"RETIRED IP PAMF ORTHO THA",2288,"14863","POTASSIUM CHLORID-D5-0.45%NACL 20 MEQ/L IV SOLP",2,174,0.0760489510489511,314,8762,0.0114942528735632,0.035836566993837,0.320740903433633,172,8448,0.129958958139285
"2019",1748,"RETIRED IP PAMF ORTHO THA",2288,"27920","OXYCODONE 10 MG PO TB12",3,685,0.299388111888112,258,7208,0.00437956204379562,0.0357935627081021,0.122356136479375,682,6950,1.85075520514323e-05
"2020",1748,"RETIRED IP PAMF ORTHO THA",2288,"27922","OXYCODONE 40 MG PO TB12",1,4,0.00174825174825175,47,1081,0.25,0.0434782608695652,5.75,3,1034,0.431308047100132
"2021",1748,"RETIRED IP PAMF ORTHO THA",2288,"83728","FONDAPARINUX 2.5 MG/0.5 ML SC SYRG",2,259,0.113199300699301,10,158,0.00772200772200772,0.0632911392405063,0.122007722007722,257,148,0.00278189350527088
"2022",1748,"RETIRED IP PAMF ORTHO THA",2288,"88043","PANTOPRAZOLE 40 MG PO TBEC",2,481,0.210227272727273,624,31884,0.00415800415800416,0.0195709446744449,0.212458020150328,479,31260,0.0232476554663384
"2023",1748,"RETIRED IP PAMF ORTHO THA",2288,"110888","ENOXAPARIN 30 MG/0.3 ML SC SYRG",5,521,0.22770979020979,73,1394,0.00959692898272553,0.0523672883787661,0.183261904135882,516,1321,4.42807044110727e-05
"2024",1748,"RETIRED IP PAMF ORTHO THA",2288,"198509","ONDANSETRON HCL (PF) 4 MG/2 ML INJ SOLN",2,830,0.362762237762238,705,36939,0.00240963855421687,0.0190855193697718,0.126254806459882,828,36234,0.000735134760208414
"2025",1748,"RETIRED IP PAMF ORTHO THA",2288,"212629","ACETAMINOPHEN 1,000 MG/100 ML (10 MG/ML) IV SOLN",1,497,0.21722027972028,510,18335,0.00201207243460765,0.0278156531224434,0.0723359766441788,496,17825,0.000797644895544126
"2026",1748,"RETIRED IP PAMF ORTHO THA",2288,"540598","THERAPEUTIC MULTIVITAMIN & MINERALS (GENERIC) PO TABS",10,752,0.328671328671329,17,1250,0.0132978723404255,0.0136,0.977784730913642,742,1233,0.999999999999999
"2027",1750,"RETIRED IP PAMF ORTHO SPINE",407,"105","ACETAMINOPHEN 650 MG PR SUPP",1,133,0.326781326781327,59,929,0.0075187969924812,0.0635091496232508,0.118389193322289,132,870,0.0157354797045704
"2028",1750,"RETIRED IP PAMF ORTHO SPINE",407,"3770","HYDROXYZINE HCL 50 MG/ML IM SOLN",17,129,0.316953316953317,18,59,0.131782945736434,0.305084745762712,0.431955211024978,112,41,0.00851437994107084
"2029",1750,"RETIRED IP PAMF ORTHO SPINE",407,"5940","OXYCODONE-ACETAMINOPHEN 5-325 MG PO TABS",1,134,0.329238329238329,218,7862,0.00746268656716418,0.0277283134062579,0.269135971518554,133,7644,0.246722210737541
"2030",1750,"RETIRED IP PAMF ORTHO SPINE",407,"14863","POTASSIUM CHLORID-D5-0.45%NACL 20 MEQ/L IV SOLP",1,120,0.294840294840295,314,8762,0.00833333333333333,0.035836566993837,0.232537154989384,119,8448,0.17085325180059
"2031",1750,"RETIRED IP PAMF ORTHO SPINE",407,"15861","D5 %-0.45 % SODIUM CHLORIDE IV SOLP",1,1,0.00245700245700246,158,4300,1,0.0367441860465116,27.2151898734177,0,4142,0.0141160166500026
"2032",1750,"RETIRED IP PAMF ORTHO SPINE",407,"27920","OXYCODONE 10 MG PO TB12",1,1,0.00245700245700246,258,7208,1,0.0357935627081021,27.937984496124,0,6950,0.0126409795875591
"2033",1750,"RETIRED IP PAMF ORTHO SPINE",407,"27921","OXYCODONE 20 MG PO TB12",1,2,0.00491400491400491,93,2927,0.5,0.0317731465664503,15.7365591397849,1,2834,0.0802743980708211
"2034",1750,"RETIRED IP PAMF ORTHO SPINE",407,"36063","0.45 % NACL-POTASSIUM CHLORIDE 20 MEQ/L IV SOLP",1,22,0.0540540540540541,24,759,0.0454545454545455,0.0316205533596838,1.4375,21,735,0.999999999999999
"2035",1750,"RETIRED IP PAMF ORTHO SPINE",407,"88043","PANTOPRAZOLE 40 MG PO TBEC",1,107,0.262899262899263,624,31884,0.00934579439252336,0.0195709446744449,0.477534148094896,106,31260,0.679527553737912
"2036",1750,"RETIRED IP PAMF ORTHO SPINE",407,"520064","CEFAZOLIN 2 G IVPB",1,63,0.154791154791155,109,2674,0.0158730158730159,0.0407629020194465,0.389398572884811,62,2565,0.503028085770801
"2037",1750,"RETIRED IP PAMF ORTHO SPINE",407,"540101","FENTANYL 50 MCG/ML IV PCA",1,15,0.0368550368550369,39,965,0.0666666666666667,0.0404145077720207,1.64957264957265,14,926,0.999999999999997
"2038",1750,"RETIRED IP PAMF ORTHO SPINE",407,"540598","THERAPEUTIC MULTIVITAMIN & MINERALS (GENERIC) PO TABS",1,131,0.321867321867322,17,1250,0.00763358778625954,0.0136,0.561293219577907,130,1233,0.866602343928154
"2039",1772,"PHARM IP THYMOGLOBULIN CYCLOSPORINE",20,"209509","METHYLPREDNISOLONE SOD SUC(PF) 125 MG/2 ML INJ SOLR",2,5,0.25,275,8000,0.4,0.034375,11.6363636363636,3,7725,0.00116256084009681
"2040",1772,"PHARM IP THYMOGLOBULIN CYCLOSPORINE",20,"520074","ANTITHYMOCYTE GLOBULIN RABBIT IVPB",2,12,0.6,75,1781,0.166666666666667,0.0421111734980348,3.95777777777778,10,1706,0.159487740318429
"2041",1777,"IP REH PHASE I EPILEPSY ADMIT",1313,"101","ACETAMINOPHEN 325 MG PO TABS",3,487,0.370906321401371,981,42092,0.00616016427104723,0.0233060914187969,0.264315631495331,484,41111,0.0186644102701994
"2042",1777,"IP REH PHASE I EPILEPSY ADMIT",1313,"2509","DIPHENHYDRAMINE HCL 25 MG PO CAPS",3,246,0.187357197258187,356,12049,0.0121951219512195,0.0295460204166321,0.412750068511921,243,11693,0.158878922374058
"2043",1777,"IP REH PHASE I EPILEPSY ADMIT",1313,"13632","BISACODYL 5 MG PO TBEC",1,333,0.253617669459254,49,3268,0.003003003003003,0.0149938800489596,0.200281914567629,332,3219,0.124632530557371
"2044",1779,"IP REH PHASE II EPILEPSY ADMIT",61,"2566","DOCUSATE SODIUM 100 MG PO CAPS",2,7,0.114754098360656,542,37509,0.285714285714286,0.0144498653656456,19.772799156563,5,36967,9.77232785515998e-06
"2045",1779,"IP REH PHASE II EPILEPSY ADMIT",61,"86533","MAGNESIUM HYDROXIDE 400 MG/5 ML PO SUSP",1,7,0.114754098360656,111,6618,0.142857142857143,0.0167724388032638,8.51737451737452,6,6507,0.262905074602558
"2046",1779,"IP REH PHASE II EPILEPSY ADMIT",61,"110892","ENOXAPARIN 40 MG/0.4 ML SC SYRG",1,3,0.0491803278688525,499,13896,0.333333333333333,0.0359096142774899,9.28256513026052,2,13397,0.2241042464862
"2047",1791,"IP ICU END OF LIFE CARE",2449,"101","ACETAMINOPHEN 325 MG PO TABS",1,27,0.0110249081257656,981,42092,0.037037037037037,0.0233060914187969,1.58915694491637,26,41111,0.999999999999999
"2048",1791,"IP ICU END OF LIFE CARE",2449,"736","ATROPINE 1 % OPHT DROP",3,140,0.0571661902817477,13,270,0.0214285714285714,0.0481481481481481,0.445054945054945,137,257,0.291001665696747
"2049",1791,"IP ICU END OF LIFE CARE",2449,"3497","GLYCOPYRROLATE 0.2 MG/ML INJ SOLN",17,660,0.269497754185382,61,1031,0.0257575757575758,0.0591658583899127,0.435345255837059,643,970,0.00209718885569453
"2050",1791,"IP ICU END OF LIFE CARE",2449,"5002","METOCLOPRAMIDE HCL 5 MG/ML INJ SOLN",5,220,0.0898325847284606,346,10128,0.0227272727272727,0.0341627172195893,0.665265370467683,215,9782,0.460065526232024
"2051",1791,"IP ICU END OF LIFE CARE",2449,"6618","PROMETHAZINE 25 MG/ML INJ SOLN",1,120,0.0489995916700694,289,5149,0.00833333333333333,0.056127403379297,0.148471741637832,119,4860,0.0387353822305805
"2052",1791,"IP ICU END OF LIFE CARE",2449,"7108","SCOPOLAMINE HBR 0.4 MG/ML INJ SOLN",3,93,0.0379746835443038,6,29,0.032258064516129,0.206896551724138,0.155913978494624,90,23,0.00624931461878801
"2053",1791,"IP ICU END OF LIFE CARE",2449,"10467","LORAZEPAM 2 MG/ML INJ SOLN",14,552,0.225398121682319,749,20621,0.0253623188405797,0.0363221958197954,0.698259515102262,538,19872,0.212124792503016
"2054",1791,"IP ICU END OF LIFE CARE",2449,"10607","MIDAZOLAM 1 MG/ML INJ SOLN",7,352,0.143732135565537,155,5616,0.0198863636363636,0.0275997150997151,0.720527859237537,345,5461,0.487174797205163
"2055",1791,"IP ICU END OF LIFE CARE",2449,"93305","SCOPOLAMINE BASE 1.5 MG (1 MG OVER 3 DAYS) TD PT3D",2,125,0.051041241322989,93,5289,0.016,0.0175836642087351,0.909935483870968,123,5196,0.999999999999982
"2056",1791,"IP ICU END OF LIFE CARE",2449,"110872","HYDROMORPHONE 2 MG/ML INJ SYRG",8,184,0.0751327072274398,738,23934,0.0434782608695652,0.0308347956881424,1.41003888299753,176,23196,0.439466696201839
"2057",1791,"IP ICU END OF LIFE CARE",2449,"112564","MORPHINE 2 MG/ML INJ SYRG",21,390,0.159248672927726,276,6156,0.0538461538461538,0.0448343079922027,1.20100334448161,369,5880,0.48153989578227
"2058",1791,"IP ICU END OF LIFE CARE",2449,"112586","HYDROMORPHONE 1 MG/ML INJ SYRG",8,177,0.0722743977133524,1219,33427,0.0451977401129944,0.036467526251234,1.23939693089177,169,32208,0.676889913160514
"2059",1791,"IP ICU END OF LIFE CARE",2449,"126132","MORPHINE (PF) IN D5W 100 MG/100 ML (1 MG/ML) IV SOLP",20,245,0.100040832993058,21,123,0.0816326530612245,0.170731707317073,0.478134110787172,225,102,0.0169906108909208
"2060",1791,"IP ICU END OF LIFE CARE",2449,"198509","ONDANSETRON HCL (PF) 4 MG/2 ML INJ SOLN",12,577,0.235606369946917,705,36939,0.0207972270363951,0.0190855193697718,1.08968619786865,565,36234,0.884890396999334
"2061",1791,"IP ICU END OF LIFE CARE",2449,"212629","ACETAMINOPHEN 1,000 MG/100 ML (10 MG/ML) IV SOLN",11,334,0.136382196815027,510,18335,0.0329341317365269,0.0278156531224434,1.18401432429259,323,17825,0.692677454862874
"2062",1791,"IP ICU END OF LIFE CARE",2449,"530003","FENTANYL  10 MCG/ML IV INFUSION",1,23,0.00939158840342997,51,585,0.0434782608695652,0.0871794871794872,0.498721227621483,22,534,0.722552320993599
"2063",1791,"IP ICU END OF LIFE CARE",2449,"530004","MIDAZOLAM 50 MG IN D5W 100 ML IV INFUSION",7,141,0.0575745202123316,65,1105,0.049645390070922,0.0588235294117647,0.843971631205674,134,1040,0.80396207345777
"2064",1791,"IP ICU END OF LIFE CARE",2449,"530019","LORAZEPAM 0.5 MG/ML IV INFUSION",6,72,0.0293997550020417,2,31,0.0833333333333333,0.0645161290322581,1.29166666666667,66,29,0.999999999999999
"2065",1791,"IP ICU END OF LIFE CARE",2449,"530120","HYDROMORPHONE 10 MG IN 100 ML IV INFUSION (SHC)",23,199,0.0812576561861984,130,2894,0.115577889447236,0.0449205252246026,2.57294163123309,176,2764,1.89115975697312e-05
"2066",1791,"IP ICU END OF LIFE CARE",2449,"540106","FENTANYL (PF) 50 MCG/ML INJECTION",6,162,0.0661494487545937,461,18637,0.037037037037037,0.0247357407308043,1.49730858841488,156,18176,0.454386201384984
"2067",1791,"IP ICU END OF LIFE CARE",2449,"541048","HYDROMORPHONE VARIABLE DOSE INJECTION",1,31,0.0126582278481013,104,5739,0.032258064516129,0.0181216239763025,1.78008684863524,30,5635,0.999999999999996
"2068",1791,"IP ICU END OF LIFE CARE",2449,"541350","MORPHINE 1 MG/ML IV INFUSION",10,63,0.0257247856267864,6,60,0.158730158730159,0.1,1.58730158730159,53,54,0.484096623601727
"2069",1799,"IP ICU CRISIS",111,"7536","SUCCINYLCHOLINE CHLORIDE 20 MG/ML INJ SOLN",1,2,0.018018018018018,28,870,0.5,0.032183908045977,15.5357142857143,1,842,0.086999225120579
"2070",1799,"IP ICU CRISIS",111,"20472","ETOMIDATE 2 MG/ML IV SOLN",1,2,0.018018018018018,32,1350,0.5,0.0237037037037037,21.09375,1,1318,0.0385476780770988
"2071",1799,"IP ICU CRISIS",111,"540106","FENTANYL (PF) 50 MCG/ML INJECTION",1,1,0.00900900900900901,461,18637,1,0.0247357407308043,40.4273318872017,0,18176,0.00223917762549783
"2072",1799,"IP ICU CRISIS",111,"540114","PROPOFOL 10 MG/ML IV INJECTION",1,2,0.018018018018018,44,2013,0.5,0.0218579234972678,22.875,1,1969,0.0292534248787832
"2073",1800,"IP ITA PHARM APHERESIS",631,"520147","ALBUMIN 5% (PHARMACY COMPOUNDED MIXTURE)",15,505,0.800316957210777,12,333,0.0297029702970297,0.036036036036036,0.824257425742574,490,321,0.757950790058368
"2074",1803,"IP ICU INTUBATION",922,"7536","SUCCINYLCHOLINE CHLORIDE 20 MG/ML INJ SOLN",4,75,0.0813449023861171,28,870,0.0533333333333333,0.032183908045977,1.65714285714286,71,842,0.522860218687502
"2075",1803,"IP ICU INTUBATION",922,"20472","ETOMIDATE 2 MG/ML IV SOLN",5,116,0.125813449023861,32,1350,0.0431034482758621,0.0237037037037037,1.81842672413793,111,1318,0.332098455052689
"2076",1803,"IP ICU INTUBATION",922,"83055","ROCURONIUM 10 MG/ML IV SOLN",2,116,0.125813449023861,45,1570,0.0172413793103448,0.0286624203821656,0.601532567049808,114,1525,0.668049748930588
"2077",1803,"IP ICU INTUBATION",922,"229762","DEXMEDETOMIDINE IN 0.9 % NACL 400 MCG/100 ML (4 MCG/ML) IV SOLN",2,40,0.0433839479392625,291,6612,0.05,0.044010889292196,1.1360824742268,38,6321,0.999999999999839
"2078",1803,"IP ICU INTUBATION",922,"236616","SUGAMMADEX 100 MG/ML IV SOLN",1,10,0.0108459869848156,1,12,0.1,0.0833333333333333,1.2,9,11,1
"2079",1803,"IP ICU INTUBATION",922,"530004","MIDAZOLAM 50 MG IN D5W 100 ML IV INFUSION",2,6,0.00650759219088937,65,1105,0.333333333333333,0.0588235294117647,5.66666666666667,4,1040,0.0503259496702918
"2080",1803,"IP ICU INTUBATION",922,"530025","DEXMEDETOMIDINE IV INFUSION",14,32,0.03470715835141,530,2902,0.4375,0.18263266712612,2.39551886792453,18,2372,0.00053850907472089
"2081",1803,"IP ICU INTUBATION",922,"530120","HYDROMORPHONE 10 MG IN 100 ML IV INFUSION (SHC)",3,46,0.0498915401301518,130,2894,0.0652173913043478,0.0449205252246026,1.45183946488294,43,2764,0.764446833372048
"2082",1803,"IP ICU INTUBATION",922,"540106","FENTANYL (PF) 50 MCG/ML INJECTION",1,89,0.096529284164859,461,18637,0.0112359550561798,0.0247357407308043,0.454239684125862,88,18176,0.633664481051764
"2083",1803,"IP ICU INTUBATION",922,"540114","PROPOFOL 10 MG/ML IV INJECTION",2,105,0.113882863340564,44,2013,0.019047619047619,0.0218579234972678,0.871428571428572,103,1969,0.999999999999999
"2084",1825,"PHARM ATIC CYTOMEGALOVIRUS IMMUNE GLOBULIN",4,"101","ACETAMINOPHEN 325 MG PO TABS",1,2,0.5,981,42092,0.5,0.0233060914187969,21.453618756371,1,41111,0.0336916546422699
"2085",1825,"PHARM ATIC CYTOMEGALOVIRUS IMMUNE GLOBULIN",4,"2509","DIPHENHYDRAMINE HCL 25 MG PO CAPS",3,4,1,356,12049,0.75,0.0295460204166321,25.3841292134831,1,11693,2.48867735141298e-12
"2086",1825,"PHARM ATIC CYTOMEGALOVIRUS IMMUNE GLOBULIN",4,"85809","CYTOMEGALOVIRUS IMMUNE GLOB 50 MG/ML IV SOLN",1,1,0.25,5,301,1,0.0166112956810631,60.2,0,296,0.000568091033889762
"2087",1828,"PHARM ATIC INTRAVENOUS IMMUNE GLOBULIN",168,"101","ACETAMINOPHEN 325 MG PO TABS",4,114,0.678571428571429,981,42092,0.0350877192982456,0.0233060914187969,1.50551710571025,110,41111,0.602029702409117
"2088",1828,"PHARM ATIC INTRAVENOUS IMMUNE GLOBULIN",168,"2508","DIPHENHYDRAMINE HCL 50 MG/ML INJ SOLN",8,205,1,399,16019,0.0390243902439024,0.0249079218428117,1.56674613362675,197,15620,0.289373484111485
"2089",1828,"PHARM ATIC INTRAVENOUS IMMUNE GLOBULIN",168,"210379","HYDROCORTISONE SOD SUCC (PF) 100 MG/2 ML INJ SOLR",4,102,0.607142857142857,313,9164,0.0392156862745098,0.0341553906591008,1.14815510868884,98,8851,0.9954249478111
"2090",1828,"PHARM ATIC INTRAVENOUS IMMUNE GLOBULIN",168,"212610","IMMUNE GLOBULIN(HUM),CAPR(IGG) 10 GRAM/100 ML (10 %) INJ SOLN",7,127,0.755952380952381,73,1504,0.0551181102362205,0.0485372340425532,1.13558407938734,120,1431,0.907795737006622
"2091",1828,"PHARM ATIC INTRAVENOUS IMMUNE GLOBULIN",168,"213662","EPINEPHRINE 1 MG/ML (1:1,000) (1ML) INJ SOLN",2,97,0.577380952380952,69,5047,0.0206185567010309,0.0136714880126808,1.5081428357986,95,4978,0.887401727677434
"2092",1841,"IP SUBCUTANEOUS INSULIN ORDER SET",65457,"2365","DEXTROSE 50 % IN WATER (D50W) IV SYRG",469,21973,0.335686022885253,134,3551,0.021344377190188,0.0377358490566038,0.565625995539981,21504,3417,3.46997676995392e-09
"2093",1841,"IP SUBCUTANEOUS INSULIN ORDER SET",65457,"16050","GLUCOSE 4 GRAM PO CHEW",372,20986,0.320607421666132,17,1600,0.0177261031163633,0.010625,1.66833911683419,20614,1583,0.044981953045891
"2094",1841,"IP SUBCUTANEOUS INSULIN ORDER SET",65457,"78748","INSULIN GLARGINE 100 UNIT/ML SC SOLN",75,1754,0.0267962173640711,348,8601,0.0427594070695553,0.0404604115800488,1.05682086265875,1679,8253,0.706071098482633
"2095",1841,"IP SUBCUTANEOUS INSULIN ORDER SET",65457,"88904","INSULIN REGULAR HUMAN 100 UNIT/ML INJ SOLN",224,5062,0.0773332111156943,482,5722,0.0442512840774397,0.0842362810206222,0.525323335043797,4838,5240,7.50206592030752e-17
"2096",1841,"IP SUBCUTANEOUS INSULIN ORDER SET",65457,"89742","INSULIN NPH HUMAN RECOMB 100 UNIT/ML SC SUSP",135,2832,0.0432650442275081,703,13345,0.0476694915254237,0.0526789059572874,0.904906635002532,2697,12642,0.29564227217485
"2097",1841,"IP SUBCUTANEOUS INSULIN ORDER SET",65457,"92835","INSULIN LISPRO 100 UNIT/ML SC SOLN",700,17102,0.261270757902134,516,10567,0.0409308852765758,0.0488312671524558,0.83821059053794,16402,10051,0.00203766484568977
"2098",1841,"IP SUBCUTANEOUS INSULIN ORDER SET",65457,"125813","INSULIN DETEMIR 100 UNIT/ML SC SOLN",37,678,0.0103579449103992,215,3971,0.0545722713864307,0.0541425333669101,1.00793716128147,641,3756,0.999999999999999
"2099",1841,"IP SUBCUTANEOUS INSULIN ORDER SET",65457,"541452","INSULIN LISPRO 100 UNIT/ML SC MILD SCALE FEEDING",36,1680,0.0256657042027591,1,117,0.0214285714285714,0.00854700854700855,2.50714285714286,1644,116,0.54050327154616
"2100",1841,"IP SUBCUTANEOUS INSULIN ORDER SET",65457,"541453","INSULIN LISPRO 100 UNIT/ML SC MODERATE SCALE FEEDING",43,2484,0.0379485769283652,6,257,0.0173107890499195,0.0233463035019455,0.741478797638218,2441,251,0.654236691737368
"2101",1841,"IP SUBCUTANEOUS INSULIN ORDER SET",65457,"541454","INSULIN LISPRO 100 UNIT/ML SC AGGRESSIVE SCALE FEEDING",50,1803,0.0275448004033182,6,238,0.0277315585135885,0.0252100840336134,1.10001848770568,1753,232,0.98985003943755
"2102",1841,"IP SUBCUTANEOUS INSULIN ORDER SET",65457,"541455","INSULIN LISPRO 100 UNIT/ML SC VERY AGGRESSIVE SCALE FEEDING",11,534,0.00815802740730556,1,100,0.0205992509363296,0.01,2.05992509363296,523,99,0.753489250943397
"2103",1841,"IP SUBCUTANEOUS INSULIN ORDER SET",65457,"541457","INSULIN LISPRO 100 UNIT/ML SC MODERATE SCALE NPO",19,1147,0.0175229540003361,1,57,0.016564952048823,0.0175438596491228,0.944202266782912,1128,56,0.99999999999999
"2104",1841,"IP SUBCUTANEOUS INSULIN ORDER SET",65457,"541461","INSULIN REGULAR 100 UNIT/ML SC MODERATE SCALE FEEDING",20,621,0.0094871442320913,2,36,0.0322061191626409,0.0555555555555556,0.579710144927536,601,34,0.778977199519159
"2105",1841,"IP SUBCUTANEOUS INSULIN ORDER SET",65457,"541462","INSULIN REGULAR 100 UNIT/ML SC AGGRESSIVE SCALE FEEDING",19,342,0.00522480406984738,1,16,0.0555555555555556,0.0625,0.888888888888889,323,15,0.999999999999993
"2106",1841,"IP SUBCUTANEOUS INSULIN ORDER SET",65457,"541463","INSULIN REGULAR 100 UNIT/ML SC VERY AGGRESSIVE SCALE FEEDING",8,106,0.00161938371755504,1,12,0.0754716981132075,0.0833333333333333,0.905660377358491,98,11,0.999999999999997
"2107",1841,"IP SUBCUTANEOUS INSULIN ORDER SET",65457,"541464","INSULIN REGULAR 100 UNIT/ML SC MILD SCALE NPO",7,364,0.00556090257726446,1,11,0.0192307692307692,0.0909090909090909,0.211538461538462,357,10,0.574135998325866
"2108",1842,"IP SUBCUTANEOUS INSULIN ADJUSTMENT ORDER SET",19111,"78748","INSULIN GLARGINE 100 UNIT/ML SC SOLN",17,319,0.0166919575113809,348,8601,0.0532915360501567,0.0404604115800488,1.31712787806724,302,8253,0.321176357111829
"2109",1842,"IP SUBCUTANEOUS INSULIN ADJUSTMENT ORDER SET",19111,"88904","INSULIN REGULAR HUMAN 100 UNIT/ML INJ SOLN",100,1830,0.0957563706765737,482,5722,0.0546448087431694,0.0842362810206222,0.648708704623268,1730,5240,4.47922086108798e-05
"2110",1842,"IP SUBCUTANEOUS INSULIN ADJUSTMENT ORDER SET",19111,"89742","INSULIN NPH HUMAN RECOMB 100 UNIT/ML SC SUSP",60,1566,0.0819423368740516,703,13345,0.0383141762452107,0.0526789059572874,0.7273153371157,1506,12642,0.0173133479194475
"2111",1842,"IP SUBCUTANEOUS INSULIN ADJUSTMENT ORDER SET",19111,"92835","INSULIN LISPRO 100 UNIT/ML SC SOLN",239,6488,0.339490345874104,516,10567,0.0368372379778052,0.0488312671524558,0.754378088588115,6249,10051,0.000253490787844653
"2112",1842,"IP SUBCUTANEOUS INSULIN ADJUSTMENT ORDER SET",19111,"125813","INSULIN DETEMIR 100 UNIT/ML SC SOLN",50,909,0.0475642300245932,215,3971,0.055005500550055,0.0541425333669101,1.01593880318264,859,3756,0.982094905606407
"2113",1842,"IP SUBCUTANEOUS INSULIN ADJUSTMENT ORDER SET",19111,"541452","INSULIN LISPRO 100 UNIT/ML SC MILD SCALE FEEDING",6,407,0.0212966354455549,1,117,0.0147420147420147,0.00854700854700855,1.72481572481572,401,116,0.954112373434769
"2114",1842,"IP SUBCUTANEOUS INSULIN ADJUSTMENT ORDER SET",19111,"541453","INSULIN LISPRO 100 UNIT/ML SC MODERATE SCALE FEEDING",20,786,0.0411281460938726,6,257,0.0254452926208651,0.0233463035019455,1.08990670059372,766,251,0.999999999999984
"2115",1842,"IP SUBCUTANEOUS INSULIN ADJUSTMENT ORDER SET",19111,"541454","INSULIN LISPRO 100 UNIT/ML SC AGGRESSIVE SCALE FEEDING",17,636,0.0332792632515305,6,238,0.0267295597484277,0.0252100840336134,1.06027253668763,619,232,0.999999999999999
"2116",1842,"IP SUBCUTANEOUS INSULIN ADJUSTMENT ORDER SET",19111,"541455","INSULIN LISPRO 100 UNIT/ML SC VERY AGGRESSIVE SCALE FEEDING",12,247,0.0129244937470567,1,100,0.048582995951417,0.01,4.8582995951417,235,99,0.160877211609823
"2117",1842,"IP SUBCUTANEOUS INSULIN ADJUSTMENT ORDER SET",19111,"541457","INSULIN LISPRO 100 UNIT/ML SC MODERATE SCALE NPO",7,326,0.0170582387106902,1,57,0.0214723926380368,0.0175438596491228,1.2239263803681,319,56,0.999999999999999
"2118",1842,"IP SUBCUTANEOUS INSULIN ADJUSTMENT ORDER SET",19111,"541461","INSULIN REGULAR 100 UNIT/ML SC MODERATE SCALE FEEDING",4,114,0.00596515096018,2,36,0.0350877192982456,0.0555555555555556,0.631578947368421,110,34,0.953321199346075
"2119",1842,"IP SUBCUTANEOUS INSULIN ADJUSTMENT ORDER SET",19111,"541462","INSULIN REGULAR 100 UNIT/ML SC AGGRESSIVE SCALE FEEDING",3,86,0.00450002616294281,1,16,0.0348837209302326,0.0625,0.558139534883721,83,15,1
"2120",1842,"IP SUBCUTANEOUS INSULIN ADJUSTMENT ORDER SET",19111,"541464","INSULIN REGULAR 100 UNIT/ML SC MILD SCALE NPO",3,68,0.00355816022186175,1,11,0.0441176470588235,0.0909090909090909,0.485294117647059,65,10,1
"2121",2030,"SHC AMB ONC BMT",9,"94670","TACROLIMUS 1 MG PO CAPS",1,5,0.555555555555556,322,9479,0.2,0.0339698280409326,5.88757763975155,4,9157,0.416117012664054
"2122",2264,"CC BMT POST BONE MARROW HARVEST",4,"15861","D5 %-0.45 % SODIUM CHLORIDE IV SOLP",1,1,0.25,158,4300,1,0.0367441860465116,27.2151898734177,0,4142,0.0141160166500026
"2123",2342,"CC BMT PRESCRIPTION MEDS HPC - APHERESIS",189,"80840","ONDANSETRON HCL 8 MG PO TABS",5,97,0.513227513227513,170,10077,0.0515463917525773,0.0168701002282425,3.0554881746513,92,9907,0.0262950235200866
"2124",2342,"CC BMT PRESCRIPTION MEDS HPC - APHERESIS",189,"112594","FILGRASTIM 300 MCG/0.5 ML INJ SYRG",1,13,0.0687830687830688,96,2178,0.0769230769230769,0.0440771349862259,1.74519230769231,12,2082,0.999999999999997
"2125",2345,"CC BMT PRESCRIPTION MEDS NON-MYELOABLATIVE",101,"4572","LORAZEPAM 0.5 MG PO TABS",1,2,0.0198019801980198,349,13238,0.5,0.0263634990179785,18.9656160458453,1,12889,0.0487278170363927
"2126",2345,"CC BMT PRESCRIPTION MEDS NON-MYELOABLATIVE",101,"8971","ACYCLOVIR 400 MG PO TABS",1,29,0.287128712871287,144,5498,0.0344827586206897,0.0261913423062932,1.31657088122605,28,5354,0.99999999999967
"2127",2353,"CC BMT PRESCRIPTION MEDS ABLATIVE ALLOGENEIC OUTPATIENT",58,"11624","URSODIOL 300 MG PO CAPS",3,40,0.689655172413793,49,2387,0.075,0.0205278592375367,3.65357142857143,37,2338,0.070446257859639
"2128",2398,"CC BMT PRESCRIPTION MEDS POST ABLATIVE AUTOLOGOUS HPCT ",10,"8971","ACYCLOVIR 400 MG PO TABS",2,6,0.6,144,5498,0.333333333333333,0.0261913423062932,12.7268518518519,4,5354,0.000653652535428509
"2129",2440,"NURSING TRIAGE PAIN MANAGEMENT PROTOCOL",702,"101","ACETAMINOPHEN 325 MG PO TABS",2,20,0.0284900284900285,981,42092,0.1,0.0233060914187969,4.29072375127421,18,41111,0.12591645547746
"2130",2440,"NURSING TRIAGE PAIN MANAGEMENT PROTOCOL",702,"3757","HYDROMORPHONE (PF) 1 MG/ML INJ SOLN",2,3,0.00427350427350427,6,25,0.666666666666667,0.24,2.77777777777778,1,19,0.384583218571728
"2131",2440,"NURSING TRIAGE PAIN MANAGEMENT PROTOCOL",702,"34505","HYDROCODONE-ACETAMINOPHEN 5-325 MG PO TABS",12,57,0.0811965811965812,603,24164,0.210526315789474,0.0249544777354743,8.43641441913241,45,23561,2.36636554441755e-17
"2132",2440,"NURSING TRIAGE PAIN MANAGEMENT PROTOCOL",702,"94176","ONDANSETRON 4 MG PO TBDL",2,3,0.00427350427350427,153,4277,0.666666666666667,0.0357727379003975,18.636165577342,1,4124,1.698305825378e-05
"2133",2440,"NURSING TRIAGE PAIN MANAGEMENT PROTOCOL",702,"112564","MORPHINE 2 MG/ML INJ SYRG",22,197,0.280626780626781,276,6156,0.111675126903553,0.0448343079922027,2.49084087397925,175,5880,2.71071048179241e-05
"2134",2440,"NURSING TRIAGE PAIN MANAGEMENT PROTOCOL",702,"112586","HYDROMORPHONE 1 MG/ML INJ SYRG",10,91,0.12962962962963,1219,33427,0.10989010989011,0.036467526251234,3.01336891164619,81,32208,0.000576618272092833
"2135",2440,"NURSING TRIAGE PAIN MANAGEMENT PROTOCOL",702,"198509","ONDANSETRON HCL (PF) 4 MG/2 ML INJ SOLN",10,200,0.284900284900285,705,36939,0.05,0.0190855193697718,2.61978723404255,190,36234,0.00355535139243901
"2136",2457,"IP GEN HEPARIN PROTOCOLS",18442,"540325","HEPARIN IV BOLUS (DVT/PE PROTOCOL)",82,852,0.0461988938293027,3,16,0.0962441314553991,0.1875,0.513302034428795,770,13,0.428201625108347
"2137",2457,"IP GEN HEPARIN PROTOCOLS",18442,"540326","HEPARIN IV BOLUS (A-FIB PROTOCOL, A-FIB & INR < 2)",40,485,0.0262986660882768,1,9,0.0824742268041237,0.111111111111111,0.742268041237113,445,8,0.999999999999998
"2138",2457,"IP GEN HEPARIN PROTOCOLS",18442,"540329","HEPARIN IV INFUSION (ACS PROTOCOL)",74,1329,0.0720637674872573,3,28,0.0556809631301731,0.107142857142857,0.519688989214949,1255,25,0.451973634839307
"2139",2457,"IP GEN HEPARIN PROTOCOLS",18442,"540336","HEPARIN IV INFUSION (DVT/PE PROTOCOL)",97,1374,0.0745038499078191,3,49,0.0705967976710335,0.0612244897959184,1.15308102862688,1277,46,0.99999999999999
"2140",2457,"IP GEN HEPARIN PROTOCOLS",18442,"540338","HEPARIN IV INFUSION (A-FIB PROTOCOL, A-FIB & INR > 2)",10,147,0.00797093590716842,1,9,0.0680272108843537,0.111111111111111,0.612244897959184,137,8,0.999999999999998
"2141",2457,"IP GEN HEPARIN PROTOCOLS",18442,"540448","HEPARIN IV INFUSION (MHV PROTOCOL, INR IS THERAPEUTIC)",11,158,0.0085674004988613,1,6,0.069620253164557,0.166666666666667,0.417721518987342,147,5,0.922418293401398
"2142",2457,"IP GEN HEPARIN PROTOCOLS",18442,"540451","HEPARIN IV INFUSION (NEURO POST STROKE PROTOCOL)",2,49,0.00265697863572281,3,5,0.0408163265306122,0.6,0.0680272108843537,47,2,0.000969218764119146
"2143",2457,"IP GEN HEPARIN PROTOCOLS",18442,"540493","WARFARIN PER PHARMACY PROTOCOL",14,194,0.0105194664353107,218,6316,0.0721649484536082,0.0345155161494617,2.0907973139128,180,6098,0.00960781491345187
"2144",2457,"IP GEN HEPARIN PROTOCOLS",18442,"540646","HEPARIN IV INFUSION (EP PROTOCOL)",4,272,0.0147489426309511,1,11,0.0147058823529412,0.0909090909090909,0.161764705882353,268,10,0.47550881819877
"2145",2457,"IP GEN HEPARIN PROTOCOLS",18442,"540665","HEPARIN IV INFUSION (DVT/PE PROTOCOL-HIGH BLEEDING RISK/POST PROCEDURE)",49,823,0.0446263962693851,3,50,0.0595382746051033,0.06,0.992304576751721,774,47,0.999999999999991
"2146",2457,"IP GEN HEPARIN PROTOCOLS",18442,"540681","HEPARIN IV INFUSION (HIGH BLEEDING RISK PROTOCOL)",68,875,0.0474460470664787,4,36,0.0777142857142857,0.111111111111111,0.699428571428571,807,32,0.679803681045291
"2147",2457,"IP GEN HEPARIN PROTOCOLS",18442,"540736","HEPARIN IV INFUSION (VASCULAR SURGERY HIGH BLEEDING RISK)",13,182,0.00986877778982757,1,6,0.0714285714285714,0.166666666666667,0.428571428571429,169,5,0.933002636507205
"2148",2457,"IP GEN HEPARIN PROTOCOLS",18442,"541066","HEPARIN INFUSION LVAD HIGH RISK BLEED",40,625,0.0338900336189134,1,22,0.064,0.0454545454545455,1.408,585,21,0.999999999999973
"2149",2457,"IP GEN HEPARIN PROTOCOLS",18442,"541074","HEPARIN INFUSION LVAD NORMAL RISK",60,1194,0.0647435202255721,2,56,0.050251256281407,0.0357142857142857,1.4070351758794,1134,54,0.861223247715599
"2150",2457,"IP GEN HEPARIN PROTOCOLS",18442,"541075","HEPARIN INFUSION LVAD HIGH PUMP THROMBOSIS RISK",10,112,0.00607309402450927,1,6,0.0892857142857143,0.166666666666667,0.535714285714286,102,5,0.999999999999992
"2151",2457,"IP GEN HEPARIN PROTOCOLS",18442,"541765","HEPARIN IV INFUSION (LVAD PROTOCOL - NORMAL RISK)",17,329,0.017839713696996,1,18,0.0516717325227964,0.0555555555555556,0.930091185410334,312,17,0.999999999999998
"2152",2473,"CC APHERESIS THERAPEUTIC PLASMA EXCHANGE",1283,"2508","DIPHENHYDRAMINE HCL 50 MG/ML INJ SOLN",1,196,0.152766952455183,399,16019,0.00510204081632653,0.0249079218428117,0.204836069766252,195,15620,0.122315056252192
"2153",2473,"CC APHERESIS THERAPEUTIC PLASMA EXCHANGE",1283,"10176","HEPARIN (PORCINE) 1,000 UNIT/ML INJ SOLN",5,462,0.360093530787217,164,2898,0.0108225108225108,0.0565907522429262,0.191241685144124,457,2734,4.79095380279545e-05
"2154",2473,"CC APHERESIS THERAPEUTIC PLASMA EXCHANGE",1283,"17362","HEPARIN, PORCINE (PF) 100 UNIT/ML IV SYRG",1,57,0.0444271239282931,202,8865,0.0175438596491228,0.0227862380146644,0.769932256383533,56,8663,0.999999999999918
"2155",2473,"CC APHERESIS THERAPEUTIC PLASMA EXCHANGE",1283,"81839","LIDOCAINE 4 % TP CREA",1,2,0.00155884645362432,31,996,0.5,0.0311244979919679,16.0645161290323,1,965,0.079904133800439
"2156",2473,"CC APHERESIS THERAPEUTIC PLASMA EXCHANGE",1283,"126992","LIDOCAINE (PF) 10 MG/ML (1 %) INJ SOLN",1,17,0.0132501948558067,457,11068,0.0588235294117647,0.0412902059992772,1.42463637533788,16,10611,0.999999999999292
"2157",2473,"CC APHERESIS THERAPEUTIC PLASMA EXCHANGE",1283,"221562","CALCIUM CHLORIDE 1 GRAM (13.6 MEQ)/50 ML NS IVPB",11,467,0.363990646921278,156,2315,0.0235546038543897,0.0673866090712743,0.34954428155713,456,2159,0.000414336850502976
"2158",2804,"IP ONC TUMOR LYSIS PRECAUTIONS",307,"310","ALLOPURINOL 100 MG PO TABS",1,5,0.0162866449511401,47,2267,0.2,0.0207322452580503,9.6468085106383,4,2220,0.219537159618252
"2159",2804,"IP ONC TUMOR LYSIS PRECAUTIONS",307,"311","ALLOPURINOL 100 MG PO TABS",2,50,0.162866449511401,63,3080,0.04,0.0204545454545455,1.95555555555556,48,3017,0.644412456020657
"2160",2804,"IP ONC TUMOR LYSIS PRECAUTIONS",307,"224461","SODIUM CHLORIDE 0.9% IV SOLP",10,37,0.120521172638436,3,52,0.27027027027027,0.0576923076923077,4.68468468468468,27,49,0.0126281728874262
"2161",2955,"IP INSULIN TRANSITION OFF IV INFUSION",11359,"2365","DEXTROSE 50 % IN WATER (D50W) IV SYRG",86,2995,0.263667576371159,134,3551,0.0287145242070117,0.0377358490566038,0.76093489148581,2909,3417,0.0513113289708187
"2162",2955,"IP INSULIN TRANSITION OFF IV INFUSION",11359,"16050","GLUCOSE 4 GRAM PO CHEW",34,2969,0.261378642486134,17,1600,0.0114516672280229,0.010625,1.07780397440216,2935,1583,0.915488030084227
"2163",2955,"IP INSULIN TRANSITION OFF IV INFUSION",11359,"78748","INSULIN GLARGINE 100 UNIT/ML SC SOLN",13,124,0.0109164539131966,348,8601,0.104838709677419,0.0404604115800488,2.59114293659622,111,8253,0.000817322864644299
"2164",2955,"IP INSULIN TRANSITION OFF IV INFUSION",11359,"88904","INSULIN REGULAR HUMAN 100 UNIT/ML INJ SOLN",35,1183,0.104146491768642,482,5722,0.029585798816568,0.0842362810206222,0.351223943627391,1148,5240,1.18817177191213e-10
"2165",2955,"IP INSULIN TRANSITION OFF IV INFUSION",11359,"89742","INSULIN NPH HUMAN RECOMB 100 UNIT/ML SC SUSP",265,7231,0.636587727792939,703,13345,0.0366477665606417,0.0526789059572874,0.695681998224414,6966,12642,2.59764587041692e-07
"2166",2955,"IP INSULIN TRANSITION OFF IV INFUSION",11359,"92835","INSULIN LISPRO 100 UNIT/ML SC SOLN",92,3772,0.332071485165948,516,10567,0.024390243902439,0.0488312671524558,0.499480052940064,3680,10051,2.18282808562984e-10
"2167",2955,"IP INSULIN TRANSITION OFF IV INFUSION",11359,"125813","INSULIN DETEMIR 100 UNIT/ML SC SOLN",8,195,0.0171670041376882,215,3971,0.041025641025641,0.0541425333669101,0.75773404889684,187,3756,0.527673772873589
"2168",2955,"IP INSULIN TRANSITION OFF IV INFUSION",11359,"541452","INSULIN LISPRO 100 UNIT/ML SC MILD SCALE FEEDING",2,88,0.00774716084162338,1,117,0.0227272727272727,0.00854700854700855,2.65909090909091,86,116,0.803096170304546
"2169",2955,"IP INSULIN TRANSITION OFF IV INFUSION",11359,"541453","INSULIN LISPRO 100 UNIT/ML SC MODERATE SCALE FEEDING",2,175,0.015406285764592,6,257,0.0114285714285714,0.0233463035019455,0.48952380952381,173,251,0.590238206942538
"2170",2955,"IP INSULIN TRANSITION OFF IV INFUSION",11359,"541454","INSULIN LISPRO 100 UNIT/ML SC AGGRESSIVE SCALE FEEDING",2,95,0.00836341227220706,6,238,0.0210526315789474,0.0252100840336134,0.835087719298246,93,232,0.999999999999999
"2171",2955,"IP INSULIN TRANSITION OFF IV INFUSION",11359,"541455","INSULIN LISPRO 100 UNIT/ML SC VERY AGGRESSIVE SCALE FEEDING",1,12,0.00105643102385773,1,100,0.0833333333333333,0.01,8.33333333333333,11,99,0.509825986881472
"2172",2955,"IP INSULIN TRANSITION OFF IV INFUSION",11359,"541457","INSULIN LISPRO 100 UNIT/ML SC MODERATE SCALE NPO",1,61,0.00537019103794348,1,57,0.0163934426229508,0.0175438596491228,0.934426229508197,60,56,1
"2173",2955,"IP INSULIN TRANSITION OFF IV INFUSION",11359,"541462","INSULIN REGULAR 100 UNIT/ML SC AGGRESSIVE SCALE FEEDING",1,18,0.0015846465357866,1,16,0.0555555555555556,0.0625,0.888888888888889,17,15,1
"2174",2956,"IP INSULIN CONTINUOUS IV INFUSION",8645,"2364","DEXTROSE 5 % IN WATER (D5W) IV SOLP",22,325,0.037593984962406,239,2728,0.0676923076923077,0.0876099706744868,0.772655294496299,303,2489,0.267439319017064
"2175",2956,"IP INSULIN CONTINUOUS IV INFUSION",8645,"2365","DEXTROSE 50 % IN WATER (D50W) IV SYRG",147,4067,0.470445344129555,134,3551,0.036144578313253,0.0377358490566038,0.957831325301205,3920,3417,0.759098990851062
"2176",2956,"IP INSULIN CONTINUOUS IV INFUSION",8645,"15882","D5 % AND 0.9 % SODIUM CHLORIDE IV SOLP",42,531,0.0614227877385772,137,3533,0.0790960451977401,0.0387772431361449,2.03975421666873,489,3396,3.98701134661701e-05
"2177",2956,"IP INSULIN CONTINUOUS IV INFUSION",8645,"112318","DEXTROSE 10% IN WATER (D10W) IV SOLP",10,125,0.0144592249855408,40,720,0.08,0.0555555555555556,1.44,115,680,0.387659581491372
"2178",2956,"IP INSULIN CONTINUOUS IV INFUSION",8645,"530049","INSULIN REGULAR 1 UNIT/ML IV INFUSION (NEW)",154,4418,0.511046847888953,23,2672,0.034857401539158,0.00860778443113772,4.04952073533175,4264,2649,1.14707745056797e-11
"2179",2956,"IP INSULIN CONTINUOUS IV INFUSION",8645,"540910","INSULIN REGULAR IV BOLUS",376,2763,0.319606709080393,1,13,0.136083966702859,0.0769230769230769,1.76909156713717,2387,12,0.829423141663085
"2180",2957,"IP/ED INSULIN - DIABETIC KETOACIDOSIS (DKA)/ HYPEROSMOLAR HYPERGLYCEMIC STATE (HHS)",950,"2365","DEXTROSE 50 % IN WATER (D50W) IV SYRG",48,446,0.469473684210526,134,3551,0.10762331838565,0.0377358490566038,2.85201793721973,398,3417,5.65478656082149e-11
"2181",2957,"IP/ED INSULIN - DIABETIC KETOACIDOSIS (DKA)/ HYPEROSMOLAR HYPERGLYCEMIC STATE (HHS)",950,"6427","POTASSIUM CHLORIDE 10 MEQ/100 ML IV PGBK",4,22,0.0231578947368421,1228,18599,0.181818181818182,0.0660250551104898,2.75377554042049,18,17371,0.0793265394506523
"2182",2957,"IP/ED INSULIN - DIABETIC KETOACIDOSIS (DKA)/ HYPEROSMOLAR HYPERGLYCEMIC STATE (HHS)",950,"7318","SODIUM CHLORIDE 0.45 % 0.45 % IV SOLP",2,18,0.0189473684210526,51,783,0.111111111111111,0.0651340996168582,1.70588235294118,16,732,0.766972881243892
"2183",2957,"IP/ED INSULIN - DIABETIC KETOACIDOSIS (DKA)/ HYPEROSMOLAR HYPERGLYCEMIC STATE (HHS)",950,"11077","POTASSIUM CHLORIDE 20 MEQ/50 ML IV PGBK",3,6,0.00631578947368421,480,9377,0.5,0.0511890796630052,9.76770833333333,3,8897,5.1315213131977e-05
"2184",2957,"IP/ED INSULIN - DIABETIC KETOACIDOSIS (DKA)/ HYPEROSMOLAR HYPERGLYCEMIC STATE (HHS)",950,"16426","NS WITH POTASSIUM CHLORIDE 20 MEQ/L IV SOLP",7,54,0.0568421052631579,118,4415,0.12962962962963,0.026727066817667,4.85012554927809,47,4297,3.42738531158235e-05
"2185",2957,"IP/ED INSULIN - DIABETIC KETOACIDOSIS (DKA)/ HYPEROSMOLAR HYPERGLYCEMIC STATE (HHS)",950,"27838","SODIUM CHLORIDE 0.9 % 0.9 % IV SOLP",6,28,0.0294736842105263,692,19620,0.214285714285714,0.0352701325178389,6.07555739058629,22,18928,4.16474319489946e-06
"2186",2957,"IP/ED INSULIN - DIABETIC KETOACIDOSIS (DKA)/ HYPEROSMOLAR HYPERGLYCEMIC STATE (HHS)",950,"36063","0.45 % NACL-POTASSIUM CHLORIDE 20 MEQ/L IV SOLP",6,42,0.0442105263157895,24,759,0.142857142857143,0.0316205533596838,4.51785714285714,36,735,0.00104367593895542
"2187",2957,"IP/ED INSULIN - DIABETIC KETOACIDOSIS (DKA)/ HYPEROSMOLAR HYPERGLYCEMIC STATE (HHS)",950,"126992","LIDOCAINE (PF) 10 MG/ML (1 %) INJ SOLN",23,202,0.212631578947368,457,11068,0.113861386138614,0.0412902059992772,2.75758823147085,179,10611,1.02903733061937e-06
"2188",2957,"IP/ED INSULIN - DIABETIC KETOACIDOSIS (DKA)/ HYPEROSMOLAR HYPERGLYCEMIC STATE (HHS)",950,"500006","SODIUM PHOSPHATE IVPB",4,37,0.0389473684210526,296,4785,0.108108108108108,0.0618599791013584,1.74762600438276,33,4489,0.413039957058599
"2189",2957,"IP/ED INSULIN - DIABETIC KETOACIDOSIS (DKA)/ HYPEROSMOLAR HYPERGLYCEMIC STATE (HHS)",950,"530048","INSULIN REGULAR 1 UNIT/ML IV INFUSION (DKA/HHS PROTOCOL)",49,451,0.474736842105263,1,17,0.108647450110865,0.0588235294117647,1.8470066518847,402,16,0.800323016015479
"2190",2957,"IP/ED INSULIN - DIABETIC KETOACIDOSIS (DKA)/ HYPEROSMOLAR HYPERGLYCEMIC STATE (HHS)",950,"540102","NS IV BOLUS",5,53,0.0557894736842105,2225,80957,0.0943396226415094,0.0274837259285794,3.43256306974772,48,78732,0.0106521594078379
"2191",2957,"IP/ED INSULIN - DIABETIC KETOACIDOSIS (DKA)/ HYPEROSMOLAR HYPERGLYCEMIC STATE (HHS)",950,"540500","SODIUM BICARBONATE 50 MEQ / 50 ML IV BAG (DKA PROTOCOL)",6,28,0.0294736842105263,1,1,0.214285714285714,1,0.214285714285714,22,0,0.538511914882501
"2192",2957,"IP/ED INSULIN - DIABETIC KETOACIDOSIS (DKA)/ HYPEROSMOLAR HYPERGLYCEMIC STATE (HHS)",950,"540501","SODIUM BICARBONATE 100 MEQ / 100 ML BAG (DKA PROTOCOL)",2,16,0.0168421052631579,1,1,0.125,1,0.125,14,0,0.381689600162199
"2193",2958,"IP INSULIN PUMP (CONTINUOUS SUBCUTANEOUS INSULIN INFUSION (CSII))",983,"2365","DEXTROSE 50 % IN WATER (D50W) IV SYRG",32,419,0.426246185147508,134,3551,0.0763723150357995,0.0377358490566038,2.02386634844869,387,3417,0.000308834415880041
"2194",2958,"IP INSULIN PUMP (CONTINUOUS SUBCUTANEOUS INSULIN INFUSION (CSII))",983,"16050","GLUCOSE 4 GRAM PO CHEW",27,400,0.406917599186165,17,1600,0.0675,0.010625,6.35294117647059,373,1583,1.52446081767711e-11
"2195",2958,"IP INSULIN PUMP (CONTINUOUS SUBCUTANEOUS INSULIN INFUSION (CSII))",983,"540499","INSULIN LISPRO SUBCUTANEOUS PUMP",12,282,0.286876907426246,1,38,0.0425531914893617,0.0263157894736842,1.61702127659574,270,37,0.969452214726594
"2196",2958,"IP INSULIN PUMP (CONTINUOUS SUBCUTANEOUS INSULIN INFUSION (CSII))",983,"540503","INSULIN ASPART SUBCUTANEOUS PUMP",5,136,0.138351983723296,2,24,0.0367647058823529,0.0833333333333333,0.441176470588235,131,22,0.626183851917404
"2197",2958,"IP INSULIN PUMP (CONTINUOUS SUBCUTANEOUS INSULIN INFUSION (CSII))",983,"540513","INSULIN LISPRO SUBCUTANEOUS PUMP BOLUS",21,531,0.540183112919634,4,44,0.0395480225988701,0.0909090909090909,0.435028248587571,510,40,0.222164599427395
"2198",2961,"IP GEN BRONCHOSCOPY PRE/INTRA/POST",2290,"4448","LIDOCAINE HCL 2 % JELLY",4,914,0.399126637554585,66,3270,0.00437636761487965,0.0201834862385321,0.216829122737219,910,3204,0.00164351061685011
"2199",2961,"IP GEN BRONCHOSCOPY PRE/INTRA/POST",2290,"4455","LIDOCAINE (PF) 40 MG/ML (4 %) INJ SOLN",5,931,0.406550218340611,50,604,0.00537056928034372,0.0827814569536424,0.0648764769065521,926,554,4.8438381562432e-15
"2200",2961,"IP GEN BRONCHOSCOPY PRE/INTRA/POST",2290,"5002","METOCLOPRAMIDE HCL 5 MG/ML INJ SOLN",3,450,0.196506550218341,346,10128,0.00666666666666667,0.0341627172195893,0.19514450867052,447,9782,0.00221014862179927
"2201",2961,"IP GEN BRONCHOSCOPY PRE/INTRA/POST",2290,"5373","NALOXONE 0.4 MG/ML INJ SOLN",5,878,0.383406113537118,83,1774,0.00569476082004556,0.0467869222096956,0.121716936081456,873,1691,5.18798973756169e-08
"2202",2961,"IP GEN BRONCHOSCOPY PRE/INTRA/POST",2290,"6618","PROMETHAZINE 25 MG/ML INJ SOLN",4,496,0.216593886462882,289,5149,0.00806451612903226,0.056127403379297,0.143682330617256,492,4860,6.71730354399157e-06
"2203",2961,"IP GEN BRONCHOSCOPY PRE/INTRA/POST",2290,"10055","FLUMAZENIL 0.1 MG/ML IV SOLN",5,780,0.34061135371179,14,238,0.00641025641025641,0.0588235294117647,0.108974358974359,775,224,7.18524672091159e-07
"2204",2961,"IP GEN BRONCHOSCOPY PRE/INTRA/POST",2290,"10607","MIDAZOLAM 1 MG/ML INJ SOLN",8,976,0.426200873362445,155,5616,0.00819672131147541,0.0275997150997151,0.296985721840296,968,5461,0.000480810158245336
"2205",2961,"IP GEN BRONCHOSCOPY PRE/INTRA/POST",2290,"27838","SODIUM CHLORIDE 0.9 % 0.9 % IV SOLP",2,171,0.0746724890829694,692,19620,0.0116959064327485,0.0352701325178389,0.331609370246425,169,18928,0.144331398260173
"2206",2961,"IP GEN BRONCHOSCOPY PRE/INTRA/POST",2290,"112564","MORPHINE 2 MG/ML INJ SYRG",2,65,0.0283842794759825,276,6156,0.0307692307692308,0.0448343079922027,0.68628762541806,63,5880,0.807066053420282
"2207",2961,"IP GEN BRONCHOSCOPY PRE/INTRA/POST",2290,"126992","LIDOCAINE (PF) 10 MG/ML (1 %) INJ SOLN",8,1283,0.560262008733624,457,11068,0.00623538581449727,0.0412902059992772,0.151013676575177,1275,10611,6.95546425140251e-10
"2208",2961,"IP GEN BRONCHOSCOPY PRE/INTRA/POST",2290,"198509","ONDANSETRON HCL (PF) 4 MG/2 ML INJ SOLN",6,885,0.38646288209607,705,36939,0.00677966101694915,0.0190855193697718,0.355225387666787,879,36234,0.0111286321971242
"2209",2961,"IP GEN BRONCHOSCOPY PRE/INTRA/POST",2290,"540106","FENTANYL (PF) 50 MCG/ML INJECTION",7,984,0.429694323144105,461,18637,0.00711382113821138,0.0247357407308043,0.287592808140663,977,18176,0.000618215251008821
"2210",2961,"IP GEN BRONCHOSCOPY PRE/INTRA/POST",2290,"540897","LIDOCAINE (PF) 20 MG/ML (2 %) INJ SOLN(ORDERSET USE ONLY)",5,988,0.431441048034934,2,5,0.00506072874493927,0.4,0.0126518218623482,983,3,4.17975907934535e-15
"2211",2972,"IP CAR CARDIOLOGY POST PROCEDURE",2659,"101","ACETAMINOPHEN 325 MG PO TABS",1,141,0.0530274539300489,981,42092,0.00709219858156028,0.0233060914187969,0.30430664902654,140,41111,0.319476878675311
"2212",2972,"IP CAR CARDIOLOGY POST PROCEDURE",2659,"10011","FAMOTIDINE 20 MG PO TABS",1,10,0.00376081233546446,472,16960,0.1,0.0278301886792453,3.59322033898305,9,16488,0.670682587745672
"2213",2972,"IP CAR CARDIOLOGY POST PROCEDURE",2659,"14113","ASPIRIN 81 MG PO TBEC",10,228,0.0857465212485897,391,18448,0.043859649122807,0.0211947094535993,2.06936779288374,218,18057,0.0342820777841748
"2214",2972,"IP CAR CARDIOLOGY POST PROCEDURE",2659,"25365","CEFAZOLIN IN DEXTROSE (ISO-OS) 1 GRAM/50 ML IV PGBK",1,22,0.00827378713802181,258,5335,0.0454545454545455,0.0483598875351453,0.939922480620155,21,5077,0.999999999999996
"2215",2972,"IP CAR CARDIOLOGY POST PROCEDURE",2659,"83398","CLOPIDOGREL 75 MG PO TABS",12,254,0.0955246333207973,234,7279,0.047244094488189,0.0321472729770573,1.46961437512619,242,7045,0.249677494975112
"2216",2972,"IP CAR CARDIOLOGY POST PROCEDURE",2659,"89797","EPTIFIBATIDE 0.75 MG/ML IV SOLN",1,15,0.00564121850319669,10,150,0.0666666666666667,0.0666666666666667,1,14,140,1
"2217",2972,"IP CAR CARDIOLOGY POST PROCEDURE",2659,"208212","PRASUGREL 10 MG PO TABS",2,65,0.024445280180519,24,451,0.0307692307692308,0.0532150776053215,0.578205128205128,63,427,0.63823336154273
"2218",2972,"IP CAR CARDIOLOGY POST PROCEDURE",2659,"214201","TICAGRELOR 90 MG PO TABS",3,36,0.0135389244076721,23,361,0.0833333333333333,0.0637119113573407,1.30797101449275,33,338,0.919910787331353
"2219",2972,"IP CAR CARDIOLOGY POST PROCEDURE",2659,"530035","BIVALIRUDIN IV INFUSION",3,12,0.00451297480255735,1,17,0.25,0.0588235294117647,4.25,9,16,0.355621424238384
"2220",2972,"IP CAR CARDIOLOGY POST PROCEDURE",2659,"540106","FENTANYL (PF) 50 MCG/ML INJECTION",2,131,0.0492666415945844,461,18637,0.0152671755725191,0.0247357407308043,0.617211173850408,129,18176,0.679170648428019
"2221",2973,"IP CAR CARDIOLOGY PREOP PROCEDURE",3317,"681","ASPIRIN 325 MG PO TABS",31,685,0.20651190835092,303,7114,0.0452554744525547,0.0425920719707619,1.06253282262533,654,6811,0.818065758904137
"2222",2973,"IP CAR CARDIOLOGY PREOP PROCEDURE",3317,"2405","DIAZEPAM 5 MG PO TABS",13,1208,0.364184504069943,152,5041,0.0107615894039735,0.0301527474707399,0.356902448588358,1195,4889,0.000237371976747181
"2223",2973,"IP CAR CARDIOLOGY PREOP PROCEDURE",3317,"2508","DIPHENHYDRAMINE HCL 50 MG/ML INJ SOLN",1,35,0.0105517033463973,399,16019,0.0285714285714286,0.0249079218428117,1.14708199069101,34,15620,0.999999999999997
"2224",2973,"IP CAR CARDIOLOGY PREOP PROCEDURE",3317,"2509","DIPHENHYDRAMINE HCL 25 MG PO CAPS",13,1271,0.383177570093458,356,12049,0.010228166797797,0.0295460204166321,0.34617747681645,1258,11693,9.56902612292414e-05
"2225",2973,"IP CAR CARDIOLOGY PREOP PROCEDURE",3317,"27838","SODIUM CHLORIDE 0.9 % 0.9 % IV SOLP",30,1081,0.325896894784444,692,19620,0.0277520814061055,0.0352701325178389,0.786843695358077,1051,18928,0.220018751449356
"2226",2973,"IP CAR CARDIOLOGY PREOP PROCEDURE",3317,"83398","CLOPIDOGREL 75 MG PO TABS",1,16,0.00482363581549593,234,7279,0.0625,0.0321472729770573,1.94417735042735,15,7045,0.999999999999997
"2227",2973,"IP CAR CARDIOLOGY PREOP PROCEDURE",3317,"202606","FAMOTIDINE (PF) 20 MG/2 ML IV SOLN",1,43,0.0129635212541453,288,4280,0.0232558139534884,0.0672897196261682,0.345607235142119,42,3992,0.398944804246623
"2228",2973,"IP CAR CARDIOLOGY PREOP PROCEDURE",3317,"208212","PRASUGREL 10 MG PO TABS",1,1,0.000301477238468496,24,451,1,0.0532150776053215,18.7916666666667,0,427,0.051466443890782
"2229",3015,"RXWARFARIN PROTOCOL (PHARMACY USE ONLY)",3364,"8749","WARFARIN 2 MG PO TABS",8,201,0.0597502972651605,73,2789,0.0398009950248756,0.0261742560057368,1.52061609759422,193,2716,0.355288941727004
"2230",3015,"RXWARFARIN PROTOCOL (PHARMACY USE ONLY)",3364,"8750","WARFARIN 2.5 MG PO TABS",12,322,0.0957193816884661,86,3039,0.0372670807453416,0.0282987824942415,1.3169146323848,310,2953,0.462117804367895
"2231",3015,"RXWARFARIN PROTOCOL (PHARMACY USE ONLY)",3364,"8751","WARFARIN 5 MG PO TABS",12,458,0.136147443519619,131,4609,0.0262008733624454,0.0284226513343458,0.921830727690923,446,4478,0.899802809549842
"2232",3015,"RXWARFARIN PROTOCOL (PHARMACY USE ONLY)",3364,"8752","WARFARIN 7.5 MG PO TABS",4,204,0.0606420927467301,54,1901,0.0196078431372549,0.0284061020515518,0.690268700072622,200,1847,0.613905327954678
"2233",3015,"RXWARFARIN PROTOCOL (PHARMACY USE ONLY)",3364,"11664","WARFARIN 1 MG PO TABS",5,211,0.0627229488703924,98,3895,0.023696682464455,0.0251604621309371,0.94182222652094,206,3797,0.999999999999926
"2234",3015,"RXWARFARIN PROTOCOL (PHARMACY USE ONLY)",3364,"19433","WARFARIN 3 MG PO TABS",3,197,0.0585612366230678,62,2384,0.0152284263959391,0.026006711409396,0.585557556901916,194,2322,0.489333703726952
"2235",3015,"RXWARFARIN PROTOCOL (PHARMACY USE ONLY)",3364,"19434","WARFARIN 6 MG PO TABS",2,113,0.0335909631391201,30,1362,0.0176991150442478,0.0220264317180617,0.80353982300885,111,1332,0.999999999999968
"2236",3015,"RXWARFARIN PROTOCOL (PHARMACY USE ONLY)",3364,"21372","WARFARIN 4 MG PO TABS",6,200,0.0594530321046373,63,2611,0.03,0.0241286863270777,1.24333333333333,194,2548,0.779410933103489
"2237",3015,"RXWARFARIN PROTOCOL (PHARMACY USE ONLY)",3364,"9000000","ZZZ IMS TEMPLATE",3,67,0.0199167657550535,1035,28824,0.0447761194029851,0.0359075770191507,1.2469824789098,64,27789,0.951361439376485
"2238",3035,"IP PAI SINGLE SHOT INTRATHECAL NARCOTICS POSTOP",1075,"5373","NALOXONE 0.4 MG/ML INJ SOLN",10,517,0.48093023255814,83,1774,0.0193423597678917,0.0467869222096956,0.413413809978793,507,1691,0.0079103000271017
"2239",3369,"IP RAD INTERVENTIONAL RADIOLOGY UTERINE EMBOLIZATION",17,"2508","DIPHENHYDRAMINE HCL 50 MG/ML INJ SOLN",2,9,0.529411764705882,399,16019,0.222222222222222,0.0249079218428117,8.92174881648566,7,15620,0.00649685024127391
"2240",3388,"IP CAR IMPELLA",51,"15846","HEPARIN (PORCINE) IN 5 % DEX 25,000 UNIT/250 ML(100 UNIT/ML) IV SOLP",2,9,0.176470588235294,68,899,0.222222222222222,0.0756395995550612,2.93790849673203,7,831,0.311313704894935
"2241",3388,"IP CAR IMPELLA",51,"540613","PVAD PURGE SOLN: DEXTROSE 20% + HEPARIN 50 UNITS/ML",2,12,0.235294117647059,1,1,0.166666666666667,1,0.166666666666667,10,0,0.505985043644893
"2242",3390,"CDU CONTRAST DYE ALLERGY",11,"2510","DIPHENHYDRAMINE HCL 50 MG PO CAPS",1,2,0.181818181818182,37,867,0.5,0.0426758938869665,11.7162162162162,1,830,0.153240770636041
"2243",3390,"CDU CONTRAST DYE ALLERGY",11,"9000000","ZZZ IMS TEMPLATE",4,6,0.545454545454545,1035,28824,0.666666666666667,0.0359075770191507,18.5661835748792,2,27789,6.32552680054908e-13
"2244",3409,"IP GI ENDOSCOPY MANOMETRY",48,"7228","SIMETHICONE 40 MG/0.6 ML PO DRPS",2,4,0.0833333333333333,18,574,0.5,0.0313588850174216,15.9444444444444,2,556,0.000185608600123402
"2245",3417,"IP TRS IVIG DESENSITIZATION ORDERS",54,"102","ACETAMINOPHEN 500 MG PO TABS",1,24,0.444444444444444,392,15968,0.0416666666666667,0.0245490981963928,1.69727891156463,23,15576,0.999999999999833
"2246",3417,"IP TRS IVIG DESENSITIZATION ORDERS",54,"2509","DIPHENHYDRAMINE HCL 25 MG PO CAPS",1,19,0.351851851851852,356,12049,0.0526315789473684,0.0295460204166321,1.78134240094619,18,11693,0.999999999999854
"2247",3417,"IP TRS IVIG DESENSITIZATION ORDERS",54,"209508","METHYLPREDNISOLONE SOD SUC(PF) 40 MG/ML INJ SOLR",3,12,0.222222222222222,155,3480,0.25,0.0445402298850575,5.61290322580645,9,3325,0.00647253806809044
"2248",3417,"IP TRS IVIG DESENSITIZATION ORDERS",54,"212610","IMMUNE GLOBULIN(HUM),CAPR(IGG) 10 GRAM/100 ML (10 %) INJ SOLN",2,29,0.537037037037037,73,1504,0.0689655172413793,0.0485372340425532,1.42087860179499,27,1431,0.943728605250382
"2249",3437,"IP EMERGENT WARFARIN REVERSAL",383,"83422","FACTOR IX COMPLEX 500 (+/-) UNIT IV SOLR",1,4,0.010443864229765,2,9,0.25,0.222222222222222,1.125,3,7,1
"2250",3437,"IP EMERGENT WARFARIN REVERSAL",383,"230057","HUMAN PROTHROMBIN COMPLEX(PCC) 500 UNIT (FII 380-800 UNIT) IV KIT",15,145,0.378590078328982,29,240,0.103448275862069,0.120833333333333,0.856123662306778,130,211,0.723181295991719
"2251",3437,"IP EMERGENT WARFARIN REVERSAL",383,"540688","PHYTONADIONE (VITAMIN K) IVPB (WARFARIN PROTOCOL)",14,170,0.443864229765013,1,4,0.0823529411764706,0.25,0.329411764705882,156,3,0.779733731570073
"2252",3449,"IP DIHYDROERGOTAMINE (DHE) PROTOCOL",233,"2516","DIPHENOXYLATE-ATROPINE 2.5-0.025 MG PO TABS",3,85,0.36480686695279,44,1787,0.0352941176470588,0.0246222719641858,1.43342245989305,82,1743,0.795132350930165
"2253",3449,"IP DIHYDROERGOTAMINE (DHE) PROTOCOL",233,"5002","METOCLOPRAMIDE HCL 5 MG/ML INJ SOLN",2,18,0.0772532188841202,346,10128,0.111111111111111,0.0341627172195893,3.252408477842,16,9782,0.252590256766003
"2254",3449,"IP DIHYDROERGOTAMINE (DHE) PROTOCOL",233,"6618","PROMETHAZINE 25 MG/ML INJ SOLN",4,45,0.1931330472103,289,5149,0.0888888888888889,0.056127403379297,1.5836985774702,41,4860,0.532654895398626
"2255",3449,"IP DIHYDROERGOTAMINE (DHE) PROTOCOL",233,"6622","PROMETHAZINE 25 MG PO TABS",1,37,0.158798283261803,35,1459,0.027027027027027,0.023989033584647,1.12664092664093,36,1424,0.999999999999914
"2256",3449,"IP DIHYDROERGOTAMINE (DHE) PROTOCOL",233,"80840","ONDANSETRON HCL 8 MG PO TABS",3,53,0.227467811158798,170,10077,0.0566037735849057,0.0168701002282425,3.35527192008879,50,9907,0.090017684063262
"2257",3449,"IP DIHYDROERGOTAMINE (DHE) PROTOCOL",233,"81141","ONDANSETRON HCL 4 MG PO TABS",1,16,0.0686695278969957,87,4024,0.0625,0.0216202783300199,2.89080459770115,15,3937,0.79489610825475
"2258",3449,"IP DIHYDROERGOTAMINE (DHE) PROTOCOL",233,"198509","ONDANSETRON HCL (PF) 4 MG/2 ML INJ SOLN",4,59,0.253218884120172,705,36939,0.0677966101694915,0.0190855193697718,3.55225387666787,55,36234,0.0243377023976432
"2259",3449,"IP DIHYDROERGOTAMINE (DHE) PROTOCOL",233,"540680","DIHYDROERGOTAMINE IN NORMAL SALINE 1 MG/ML IN 100 ML IVPB",8,97,0.416309012875536,4,47,0.0824742268041237,0.0851063829787234,0.969072164948454,89,43,0.999999999999997
"2260",3450,"IP MAINTENANCE DIHYDROERGOTAMINE (DHE) INFUSIONS (BASED ON VAS)",106,"80840","ONDANSETRON HCL 8 MG PO TABS",1,40,0.377358490566038,170,10077,0.025,0.0168701002282425,1.48191176470588,39,9907,0.999999999999696
"2261",3450,"IP MAINTENANCE DIHYDROERGOTAMINE (DHE) INFUSIONS (BASED ON VAS)",106,"81141","ONDANSETRON HCL 4 MG PO TABS",3,16,0.150943396226415,87,4024,0.1875,0.0216202783300199,8.67241379310345,13,3937,0.000274432132688052
"2262",3450,"IP MAINTENANCE DIHYDROERGOTAMINE (DHE) INFUSIONS (BASED ON VAS)",106,"540680","DIHYDROERGOTAMINE IN NORMAL SALINE 1 MG/ML IN 100 ML IVPB",14,124,1,4,47,0.112903225806452,0.0851063829787234,1.32661290322581,110,43,0.802819710159758
"2263",3452,"IP CAR CONGESTIVE HEART FAILURE",921,"3291","FUROSEMIDE 10 MG/ML INJ SOLN",2,96,0.104234527687296,1985,57715,0.0208333333333333,0.0343931386987785,0.605740973971452,94,55730,0.653922288472766
"2264",3452,"IP CAR CONGESTIVE HEART FAILURE",921,"3700","HYDRALAZINE 25 MG PO TABS",2,11,0.011943539630836,151,3336,0.181818181818182,0.0452637889688249,4.01685731487056,9,3185,0.149338591940786
"2265",3452,"IP CAR CONGESTIVE HEART FAILURE",921,"4065","ISOSORBIDE DINITRATE 20 MG PO TABS",2,14,0.0152008686210641,35,930,0.142857142857143,0.0376344086021505,3.79591836734694,12,895,0.186856932657342
"2266",3452,"IP CAR CONGESTIVE HEART FAILURE",921,"4526","LISINOPRIL 20 MG PO TABS",1,3,0.00325732899022801,112,3482,0.333333333333333,0.032165422171166,10.3630952380952,2,3370,0.189090181570672
"2267",3452,"IP CAR CONGESTIVE HEART FAILURE",921,"7437","SPIRONOLACTONE 25 MG PO TABS",1,10,0.01085776330076,182,6011,0.1,0.0302778239893529,3.30274725274725,9,5829,0.717749936803831
"2268",3452,"IP CAR CONGESTIVE HEART FAILURE",921,"10449","LISINOPRIL 10 MG PO TABS",1,3,0.00325732899022801,199,5437,0.333333333333333,0.03660106676476,9.107202680067,2,5238,0.23171461807719
"2269",3452,"IP CAR CONGESTIVE HEART FAILURE",921,"15980","DOBUTAMINE IN D5W 500 MG/250 ML (2,000 MCG/ML) IV SOLP",1,6,0.00651465798045603,33,665,0.166666666666667,0.0496240601503759,3.35858585858586,5,632,0.714044005788535
"2270",3452,"IP CAR CONGESTIVE HEART FAILURE",921,"78198","CARVEDILOL 6.25 MG PO TABS",1,2,0.00217155266015201,136,4444,0.5,0.0306030603060306,16.3382352941176,1,4308,0.0727976253722989
"2271",3452,"IP CAR CONGESTIVE HEART FAILURE",921,"78559","CARVEDILOL 12.5 MG PO TABS",1,1,0.001085776330076,92,2497,1,0.0368442130556668,27.1413043478261,0,2405,0.0144926994956575
"2272",3452,"IP CAR CONGESTIVE HEART FAILURE",921,"110892","ENOXAPARIN 40 MG/0.4 ML SC SYRG",1,44,0.0477741585233442,499,13896,0.0227272727272727,0.0359096142774899,0.632902167972308,43,13397,0.949376708469257
"2273",3452,"IP CAR CONGESTIVE HEART FAILURE",921,"212945","HEPARIN, PORCINE (PF) 5,000 UNIT/0.5 ML INJ SOLN",3,129,0.140065146579805,452,13480,0.0232558139534884,0.0335311572700297,0.693558345338547,126,13028,0.689108187408437
"2274",3452,"IP CAR CONGESTIVE HEART FAILURE",921,"9000000","ZZZ IMS TEMPLATE",1,1,0.001085776330076,1035,28824,1,0.0359075770191507,27.8492753623188,0,27789,0.012664547841265
"2275",3509,"PRE-ADMISSION/PRE-OP ORDERS",38646,"101","ACETAMINOPHEN 325 MG PO TABS",17,1353,0.0350100916006831,981,42092,0.0125646711012565,0.0233060914187969,0.539115327211098,1336,41111,0.012288826541504
"2276",3509,"PRE-ADMISSION/PRE-OP ORDERS",38646,"102","ACETAMINOPHEN 500 MG PO TABS",33,1880,0.0486466904724939,392,15968,0.0175531914893617,0.0245490981963928,0.715023881893183,1847,15576,0.0715619453175153
"2277",3509,"PRE-ADMISSION/PRE-OP ORDERS",38646,"4318","LACTATED RINGERS IV SOLP",53,2047,0.0529679656368059,135,4847,0.0258915486077186,0.0278522797606767,0.929602489641571,1994,4712,0.707076731463051
"2278",3509,"PRE-ADMISSION/PRE-OP ORDERS",38646,"5018","METRONIDAZOLE IN NACL (ISO-OS) 500 MG/100 ML IV PGBK",31,866,0.0224085286963722,223,3847,0.035796766743649,0.0579672472056148,0.617534357232366,835,3624,0.0115001066143191
"2279",3509,"PRE-ADMISSION/PRE-OP ORDERS",38646,"9516","CHLORHEXIDINE GLUCONATE 0.12 % MM MWSH",19,798,0.0206489675516224,89,4372,0.0238095238095238,0.0203568161024703,1.16960941680043,779,4283,0.622316541243438
"2280",3509,"PRE-ADMISSION/PRE-OP ORDERS",38646,"9626","CLINDAMYCIN IN 5 % DEXTROSE 600 MG/50 ML IV PGBK",15,355,0.00918594421156135,70,1432,0.0422535211267606,0.0488826815642458,0.864386317907445,340,1362,0.699471405873588
"2281",3509,"PRE-ADMISSION/PRE-OP ORDERS",38646,"9627","CLINDAMYCIN IN DEXTROSE 5% 900 MG/50 ML IV PGBK",12,467,0.012084044920561,29,474,0.0256959314775161,0.0611814345991561,0.419995569666987,455,445,0.0121958134575149
"2282",3509,"PRE-ADMISSION/PRE-OP ORDERS",38646,"10814","OXYCODONE 5 MG PO TABS",1,361,0.00934119960668633,1478,56614,0.00277008310249307,0.0261066167379094,0.106106552614711,360,55136,0.00896050333274044
"2283",3509,"PRE-ADMISSION/PRE-OP ORDERS",38646,"18308","GABAPENTIN 300 MG PO CAPS",46,3469,0.0897634942814263,588,19458,0.013260305563563,0.0302189330866482,0.438807866761579,3423,18870,2.76972049057185e-08
"2284",3509,"PRE-ADMISSION/PRE-OP ORDERS",38646,"24176","MIDAZOLAM 2 MG/ML PO SYRP",1,7,0.000181131294312477,1,8,0.142857142857143,0.125,1.14285714285714,6,7,1
"2285",3509,"PRE-ADMISSION/PRE-OP ORDERS",38646,"25365","CEFAZOLIN IN DEXTROSE (ISO-OS) 1 GRAM/50 ML IV PGBK",156,5074,0.131294312477359,258,5335,0.030744974379188,0.0483598875351453,0.635753636871969,4918,5077,5.45659395080979e-06
"2286",3509,"PRE-ADMISSION/PRE-OP ORDERS",38646,"25855","GABAPENTIN 600 MG PO TABS",1,113,0.00292397660818713,296,6004,0.00884955752212389,0.0493004663557628,0.179502511360918,112,5708,0.0782093969712637
"2287",3509,"PRE-ADMISSION/PRE-OP ORDERS",38646,"27838","SODIUM CHLORIDE 0.9 % 0.9 % IV SOLP",183,3583,0.0927133467888009,692,19620,0.051074518559866,0.0352701325178389,1.44809545396614,3400,18928,6.2155280885203e-06
"2288",3509,"PRE-ADMISSION/PRE-OP ORDERS",38646,"77052","CELECOXIB 200 MG PO CAPS",37,3020,0.0781452155462402,20,1192,0.0122516556291391,0.0167785234899329,0.730198675496689,2983,1172,0.318578557278556
"2289",3509,"PRE-ADMISSION/PRE-OP ORDERS",38646,"81505","CIPROFLOXACIN IN D5W 400 MG/200 ML IV PGBK",4,124,0.0032086114992496,242,3682,0.032258064516129,0.0657251493753395,0.490802452679286,120,3440,0.191854663073926
"2290",3509,"PRE-ADMISSION/PRE-OP ORDERS",38646,"93305","SCOPOLAMINE BASE 1.5 MG (1 MG OVER 3 DAYS) TD PT3D",1,49,0.00126791906018734,93,5289,0.0204081632653061,0.0175836642087351,1.16063199473338,48,5196,0.999999999999994
"2291",3509,"PRE-ADMISSION/PRE-OP ORDERS",38646,"110888","ENOXAPARIN 30 MG/0.3 ML SC SYRG",1,55,0.00142317445531232,73,1394,0.0181818181818182,0.0523672883787661,0.34719800747198,54,1321,0.413729481211886
"2292",3509,"PRE-ADMISSION/PRE-OP ORDERS",38646,"110892","ENOXAPARIN 40 MG/0.4 ML SC SYRG",16,159,0.00411426797081199,499,13896,0.10062893081761,0.0359096142774899,2.80228381290884,143,13397,4.01333108789565e-05
"2293",3509,"PRE-ADMISSION/PRE-OP ORDERS",38646,"124216","VANCOMYCIN IN D5W 1 GRAM/200 ML IV PGBK",13,639,0.0165346995808104,1951,16917,0.0203442879499218,0.115327776792576,0.176404059071669,626,14966,1.23020963334095e-13
"2294",3509,"PRE-ADMISSION/PRE-OP ORDERS",38646,"125758","PREGABALIN 75 MG PO CAPS",15,587,0.0151891528230606,31,1474,0.0255536626916525,0.0210312075983718,1.21503544540309,572,1443,0.644018682230468
"2295",3509,"PRE-ADMISSION/PRE-OP ORDERS",38646,"126993","LIDOCAINE (PF) 20 MG/ML (2 %) INJ SOLN",167,2732,0.0706929565802412,163,1180,0.0611273792093704,0.138135593220339,0.442517223724277,2565,1017,2.98438365657354e-15
"2296",3509,"PRE-ADMISSION/PRE-OP ORDERS",38646,"205597","ALVIMOPAN 12 MG PO CAPS",12,478,0.0123686798116235,28,1117,0.0251046025104603,0.0250671441360788,1.001494321578,466,1089,0.999999999999997
"2297",3509,"PRE-ADMISSION/PRE-OP ORDERS",38646,"212945","HEPARIN, PORCINE (PF) 5,000 UNIT/0.5 ML INJ SOLN",90,3144,0.0813538270454898,452,13480,0.0286259541984733,0.0335311572700297,0.853712085388097,3054,13028,0.180631285119874
"2298",3509,"PRE-ADMISSION/PRE-OP ORDERS",38646,"236263","CEFAZOLIN IN DEXTROSE (ISO-OS) 2 GRAM/100 ML IV PGBK",213,4737,0.122574134451172,111,2584,0.0449651678277391,0.0429566563467492,1.0467566997016,4524,2473,0.733953797975155
"2299",3509,"PRE-ADMISSION/PRE-OP ORDERS",38646,"520064","CEFAZOLIN 2 G IVPB",91,3440,0.0890130932049889,109,2674,0.026453488372093,0.0407629020194465,0.648959889054832,3349,2565,0.00230539781714132
"2300",3509,"PRE-ADMISSION/PRE-OP ORDERS",38646,"520160","ERTAPENEM 1 G IVPB",7,88,0.00227707912849972,3,142,0.0795454545454545,0.0211267605633803,3.76515151515152,81,139,0.0752624382770112
"2301",3509,"PRE-ADMISSION/PRE-OP ORDERS",38646,"541104","CEFOXITIN 1 GRAM/50 ML MINI-BAG PLUS",24,396,0.0102468560782487,9,214,0.0606060606060606,0.0420560747663551,1.44107744107744,372,205,0.435974729006661
"2302",3509,"PRE-ADMISSION/PRE-OP ORDERS",38646,"541105","CEFOXITIN 2 GRAM/50 ML MINI-BAG PLUS",35,999,0.0258500232883093,25,530,0.035035035035035,0.0471698113207547,0.742742742742743,964,505,0.305555323402237
"2303",3509,"PRE-ADMISSION/PRE-OP ORDERS",38646,"541110","ERTAPENEM 1 GRAM/50 ML MINI-BAG PLUS",26,558,0.0144387517466232,72,1340,0.046594982078853,0.0537313432835821,0.867184388689765,532,1268,0.59871044324706
"2304",3509,"PRE-ADMISSION/PRE-OP ORDERS",38646,"541128","PATCH CHECK",2,49,0.00126791906018734,312,8338,0.0408163265306122,0.0374190453346126,1.09079016221873,47,8026,0.999999999999928
"2305",3509,"PRE-ADMISSION/PRE-OP ORDERS",38646,"541228","CEFAZOLIN IVPB (COMPOUNDED)",10,447,0.0115665269368111,10,117,0.0223713646532438,0.0854700854700855,0.261744966442953,437,107,0.00265863896342189
"2306",3509,"PRE-ADMISSION/PRE-OP ORDERS",38646,"541537","CEFAZOLIN (KEFZOL,ANCEF) 2 GM/100 ML PREMIX BAG",1,85,0.00219945143093722,2,47,0.0117647058823529,0.0425531914893617,0.276470588235294,84,45,0.598414883182385
"2307",3533,"IP ECHO EXERCISE STRESS TEST",45,"5007","METOPROLOL TARTRATE 5 MG/5 ML IV SOLN",2,18,0.4,745,12385,0.111111111111111,0.0601534113847396,1.84712900820283,16,11640,0.680081876033735
"2308",3533,"IP ECHO EXERCISE STRESS TEST",45,"5604","NITROGLYCERIN 0.4 MG SL SUBL",3,20,0.444444444444444,77,2947,0.15,0.0261282660332542,5.74090909090909,17,2870,0.00660859683101423
"2309",3533,"IP ECHO EXERCISE STRESS TEST",45,"9869","DILTIAZEM HCL 5 MG/ML IV SOLN",2,17,0.377777777777778,148,2043,0.117647058823529,0.0724424865394028,1.62400635930048,15,1895,0.805913921933792
"2310",3533,"IP ECHO EXERCISE STRESS TEST",45,"111387","ADENOSINE 3 MG/ML IV SYRG",3,16,0.355555555555556,8,116,0.1875,0.0689655172413793,2.71875,13,108,0.260284833869649
"2311",3534,"IP ECHO DOBUTAMINE STRESS TEST",86,"730","ATROPINE 0.1 MG/ML INJ SYRG",4,41,0.476744186046512,11,381,0.0975609756097561,0.0288713910761155,3.37915742793792,37,370,0.0697877649017353
"2312",3534,"IP ECHO DOBUTAMINE STRESS TEST",86,"5007","METOPROLOL TARTRATE 5 MG/5 ML IV SOLN",2,38,0.441860465116279,745,12385,0.0526315789473684,0.0601534113847396,0.874955845990816,36,11640,0.999999999999992
"2313",3534,"IP ECHO DOBUTAMINE STRESS TEST",86,"5604","NITROGLYCERIN 0.4 MG SL SUBL",3,41,0.476744186046512,77,2947,0.0731707317073171,0.0261282660332542,2.80044345898004,38,2870,0.171909910676004
"2314",3534,"IP ECHO DOBUTAMINE STRESS TEST",86,"9869","DILTIAZEM HCL 5 MG/ML IV SOLN",3,40,0.465116279069767,148,2043,0.075,0.0724424865394028,1.03530405405405,37,1895,0.999999999999999
"2315",3534,"IP ECHO DOBUTAMINE STRESS TEST",86,"111387","ADENOSINE 3 MG/ML IV SYRG",4,41,0.476744186046512,8,116,0.0975609756097561,0.0689655172413793,1.41463414634146,37,108,0.802238881864101
"2316",3534,"IP ECHO DOBUTAMINE STRESS TEST",86,"206098","DOBUTAMINE IN D5W 250 MG/250 ML (1 MG/ML) IV SOLP",8,41,0.476744186046512,1,6,0.195121951219512,0.166666666666667,1.17073170731707,33,5,0.999999999999998
"2317",3542,"IP PAI INTRATHECAL INFUSION",137,"198509","ONDANSETRON HCL (PF) 4 MG/2 ML INJ SOLN",4,61,0.445255474452555,705,36939,0.0655737704918033,0.0190855193697718,3.43578653644925,57,36234,0.0293399804470907
"2318",3550,"IP VAD GENERAL ADMIT",689,"681","ASPIRIN 325 MG PO TABS",1,11,0.0159651669085631,303,7114,0.0909090909090909,0.0425920719707619,2.13441344134413,10,6811,0.963481062676902
"2319",3550,"IP VAD GENERAL ADMIT",689,"11664","WARFARIN 1 MG PO TABS",1,3,0.00435413642960813,98,3895,0.333333333333333,0.0251604621309371,13.2482993197279,2,3797,0.119746633668864
"2320",3550,"IP VAD GENERAL ADMIT",689,"15846","HEPARIN (PORCINE) IN 5 % DEX 25,000 UNIT/250 ML(100 UNIT/ML) IV SOLP",1,4,0.0058055152394775,68,899,0.25,0.0756395995550612,3.30514705882353,3,831,0.713910403416097
"2321",3550,"IP VAD GENERAL ADMIT",689,"540493","WARFARIN PER PHARMACY PROTOCOL",6,159,0.230769230769231,218,6316,0.0377358490566038,0.0345155161494617,1.09330102129133,153,6098,0.999999999999875
"2322",3564,"ANE ECT PACU ORDERS",1096,"102","ACETAMINOPHEN 500 MG PO TABS",105,526,0.47992700729927,392,15968,0.199619771863118,0.0245490981963928,8.13145029875068,421,15576,7.34881060238927e-117
"2323",3564,"ANE ECT PACU ORDERS",1096,"4318","LACTATED RINGERS IV SOLP",114,594,0.541970802919708,135,4847,0.191919191919192,0.0278522797606767,6.89060980172091,480,4712,4.29141661989186e-72
"2324",3564,"ANE ECT PACU ORDERS",1096,"10372","LABETALOL 5 MG/ML IV SOLN",115,578,0.527372262773723,370,5898,0.198961937716263,0.0627331298745337,3.17156083419059,463,5528,4.3032715454859e-32
"2325",3564,"ANE ECT PACU ORDERS",1096,"34505","HYDROCODONE-ACETAMINOPHEN 5-325 MG PO TABS",95,469,0.427919708029197,603,24164,0.202558635394456,0.0249544777354743,8.11712581371748,374,23561,3.05739684624923e-115
"2326",3564,"ANE ECT PACU ORDERS",1096,"198509","ONDANSETRON HCL (PF) 4 MG/2 ML INJ SOLN",112,571,0.520985401459854,705,36939,0.19614711033275,0.0190855193697718,10.2772739128815,459,36234,3.79039726590927e-180
"2327",3567,"IP BONE MARROW AND ASPIRATE",1299,"3758","HYDROMORPHONE 2 MG/ML INJ SOLN",3,7,0.00538876058506543,2,86,0.428571428571429,0.0232558139534884,18.4285714285714,4,84,0.000215004748018797
"2328",3567,"IP BONE MARROW AND ASPIRATE",1299,"4573","LORAZEPAM 1 MG PO TABS",1,12,0.0092378752886836,337,8494,0.0833333333333333,0.0396750647515894,2.10039564787339,11,8157,0.972677457746971
"2329",3567,"IP BONE MARROW AND ASPIRATE",1299,"10467","LORAZEPAM 2 MG/ML INJ SOLN",1,109,0.0839107005388761,749,20621,0.00917431192660551,0.0363221958197954,0.252581423549442,108,19872,0.208868711661628
"2330",3567,"IP BONE MARROW AND ASPIRATE",1299,"110872","HYDROMORPHONE 2 MG/ML INJ SYRG",1,98,0.0754426481909161,738,23934,0.0102040816326531,0.0308347956881424,0.330927492948399,97,23196,0.374851506493692
"2331",3568,"RETIRED IP GYN-ONC SMAC LAPAROSCOPY POST-OP",126,"5002","METOCLOPRAMIDE HCL 5 MG/ML INJ SOLN",2,54,0.428571428571429,346,10128,0.037037037037037,0.0341627172195893,1.08413615928067,52,9782,0.999999999999999
"2332",3568,"RETIRED IP GYN-ONC SMAC LAPAROSCOPY POST-OP",126,"198509","ONDANSETRON HCL (PF) 4 MG/2 ML INJ SOLN",2,51,0.404761904761905,705,36939,0.0392156862745098,0.0190855193697718,2.05473508552357,49,36234,0.590919861559563
"2333",3575,"IP ICU VAD POST OP",1605,"680","ASPIRIN 81 MG PO CHEW",1,17,0.0105919003115265,357,11203,0.0588235294117647,0.031866464339909,1.84593837535014,16,10846,0.99999999999904
"2334",3575,"IP ICU VAD POST OP",1605,"2566","DOCUSATE SODIUM 100 MG PO CAPS",3,31,0.0193146417445483,542,37509,0.0967741935483871,0.0144498653656456,6.69723842399714,28,36967,0.00207420387343343
"2335",3575,"IP ICU VAD POST OP",1605,"9516","CHLORHEXIDINE GLUCONATE 0.12 % MM MWSH",5,182,0.113395638629283,89,4372,0.0274725274725275,0.0203568161024703,1.34954932707742,177,4283,0.692472865624093
"2336",3575,"IP ICU VAD POST OP",1605,"10050","FLUCONAZOLE IN NACL (ISO-OSM) 400 MG/200 ML IV PGBK",9,178,0.110903426791277,40,1102,0.050561797752809,0.0362976406533575,1.39297752808989,169,1062,0.477835705309591
"2337",3575,"IP ICU VAD POST OP",1605,"14862","POTASSIUM CHLORIDE-D5-0.2%NACL 20 MEQ/L IV SOLP",5,149,0.0928348909657321,10,92,0.0335570469798658,0.108695652173913,0.308724832214765,144,82,0.0383390893075648
"2338",3575,"IP ICU VAD POST OP",1605,"82384","PANTOPRAZOLE 40 MG IV SOLR",5,93,0.0579439252336449,688,12925,0.0537634408602151,0.0532301740812379,1.01001812953238,88,12237,0.99999999999967
"2339",3575,"IP ICU VAD POST OP",1605,"125505","SILDENAFIL 20 MG PO TABS",9,160,0.0996884735202492,60,1707,0.05625,0.0351493848857645,1.6003125,151,1647,0.256942271366103
"2340",3575,"IP ICU VAD POST OP",1605,"206169","DOPAMINE IN 5 % DEXTROSE 400 MG/250 ML (1,600 MCG/ML) IV SOLN",5,96,0.0598130841121495,62,1778,0.0520833333333333,0.0348706411698538,1.49361559139785,91,1716,0.546788870574038
"2341",3575,"IP ICU VAD POST OP",1605,"211084","CALCIUM GLUCONATE IN 0.9% NACL 1 GRAM/50 ML IV SOLN",5,194,0.120872274143302,326,12268,0.0257731958762887,0.0265731985653733,0.969894377332237,189,11942,0.999999999999995
"2342",3575,"IP ICU VAD POST OP",1605,"221562","CALCIUM CHLORIDE 1 GRAM (13.6 MEQ)/50 ML NS IVPB",12,197,0.122741433021807,156,2315,0.0609137055837563,0.0673866090712743,0.903943771964077,185,2159,0.841024836992993
"2343",3575,"IP ICU VAD POST OP",1605,"229762","DEXMEDETOMIDINE IN 0.9 % NACL 400 MCG/100 ML (4 MCG/ML) IV SOLN",1,27,0.0168224299065421,291,6612,0.037037037037037,0.044010889292196,0.841542573501336,26,6321,0.999999999999986
"2344",3575,"IP ICU VAD POST OP",1605,"520046","VANCOMYCIN IVPB (CUSTOM DOSE)",41,214,0.133333333333333,1808,23328,0.191588785046729,0.0775034293552812,2.47200396989496,173,21520,1.46816624421624e-09
"2345",3575,"IP ICU VAD POST OP",1605,"520102","CEFEPIME 2 GM IVPB",1,17,0.0105919003115265,26,498,0.0588235294117647,0.0522088353413655,1.12669683257919,16,472,0.999999999999999
"2346",3575,"IP ICU VAD POST OP",1605,"530001","AMIODARONE INFUSION PERIPH ADMIN",1,3,0.00186915887850467,7,168,0.333333333333333,0.0416666666666667,8,2,161,0.32118924111968
"2347",3575,"IP ICU VAD POST OP",1605,"530006","EPINEPHRINE IV INFUSION",6,142,0.0884735202492212,99,2540,0.0422535211267606,0.0389763779527559,1.08408023900982,136,2441,0.999999999999989
"2348",3575,"IP ICU VAD POST OP",1605,"530031","VASOPRESSIN 1 UNIT/ML IV INFUSION",4,27,0.0168224299065421,215,4489,0.148148148148148,0.0478948540877701,3.0931955211025,23,4274,0.049006296476892
"2349",3575,"IP ICU VAD POST OP",1605,"540102","NS IV BOLUS",8,118,0.0735202492211838,2225,80957,0.0677966101694915,0.0274837259285794,2.46679108741192,110,78732,0.0167401284113686
"2350",3575,"IP ICU VAD POST OP",1605,"540115","LACTATED RINGERS IV BOLUS",7,118,0.0735202492211838,400,12941,0.0593220338983051,0.0309095124024419,1.91921610169492,111,12541,0.133088905951855
"2351",3575,"IP ICU VAD POST OP",1605,"540302","POTASSIUM CHLORIDE IV SCALE",5,211,0.131464174454829,150,4660,0.023696682464455,0.0321888412017167,0.736176935229068,206,4510,0.626328886608543
"2352",3575,"IP ICU VAD POST OP",1605,"540304","MAGNESIUM SULFATE IV SCALE ",6,196,0.122118380062305,78,4104,0.0306122448979592,0.0190058479532164,1.61067503924647,190,4026,0.377303191158551
"2353",3575,"IP ICU VAD POST OP",1605,"541084","CEFEPIME 2 GRAM/100 ML MINI-BAG PLUS",4,82,0.0510903426791277,277,3459,0.0487804878048781,0.0800809482509396,0.609139737606762,78,3182,0.406692674850542
"2354",3575,"IP ICU VAD POST OP",1605,"541106","CEFTAZIDIME 1 GRAM/50 ML MINI-BAG PLUS",6,101,0.0629283489096573,14,162,0.0594059405940594,0.0864197530864197,0.687411598302687,95,148,0.572290782108354
"2355",3580,"IP TRANSESOPHAGEAL ECHO (TEE) ORDER SET",379,"5373","NALOXONE 0.4 MG/ML INJ SOLN",2,189,0.49868073878628,83,1774,0.0105820105820106,0.0467869222096956,0.226174539427551,187,1691,0.0326149813292961
"2356",3580,"IP TRANSESOPHAGEAL ECHO (TEE) ORDER SET",379,"10055","FLUMAZENIL 0.1 MG/ML IV SOLN",2,188,0.496042216358839,14,238,0.0106382978723404,0.0588235294117647,0.180851063829787,186,224,0.019244147468067
"2357",3580,"IP TRANSESOPHAGEAL ECHO (TEE) ORDER SET",379,"10607","MIDAZOLAM 1 MG/ML INJ SOLN",2,188,0.496042216358839,155,5616,0.0106382978723404,0.0275997150997151,0.385449553877831,186,5461,0.237356928296537
"2358",3580,"IP TRANSESOPHAGEAL ECHO (TEE) ORDER SET",379,"82190","BUTAMBEN-TETRACAINE-BENZOCAINE 2-2-14 % TP SPRA",2,175,0.461741424802111,12,304,0.0114285714285714,0.0394736842105263,0.28952380952381,173,292,0.140754297108009
"2359",3580,"IP TRANSESOPHAGEAL ECHO (TEE) ORDER SET",379,"90788","LIDOCAINE HCL 2 % VISCOUS ORAL SOLN",2,186,0.490765171503958,77,1939,0.010752688172043,0.0397111913357401,0.270772238514174,184,1862,0.073263897337984
"2360",3580,"IP TRANSESOPHAGEAL ECHO (TEE) ORDER SET",379,"540102","NS IV BOLUS",3,180,0.474934036939314,2225,80957,0.0166666666666667,0.0274837259285794,0.606419475655431,177,78732,0.510041803319919
"2361",3580,"IP TRANSESOPHAGEAL ECHO (TEE) ORDER SET",379,"540106","FENTANYL (PF) 50 MCG/ML INJECTION",3,191,0.503957783641161,461,18637,0.0157068062827225,0.0247357407308043,0.634984270479608,188,18176,0.57125081720517
"2362",3584,"IP RESP INHALED EPOPROSTENOL (VELETRI)",2101,"221561","EPOPROSTENOL INHALATION BAG",23,698,0.332222751070919,64,1336,0.0329512893982808,0.0479041916167665,0.687858166189112,675,1272,0.142404021371034
"2363",3591,"IP TRS HEART TRANSPLANT READMIT",548,"27838","SODIUM CHLORIDE 0.9 % 0.9 % IV SOLP",2,12,0.0218978102189781,692,19620,0.166666666666667,0.0352701325178389,4.72543352601156,10,18928,0.0925213229768856
"2364",3591,"IP TRS HEART TRANSPLANT READMIT",548,"81839","LIDOCAINE 4 % TP CREA",1,40,0.072992700729927,31,996,0.025,0.0311244979919679,0.803225806451613,39,965,0.999999999999988
"2365",3591,"IP TRS HEART TRANSPLANT READMIT",548,"92173","ZOLPIDEM 5 MG PO TABS",1,18,0.0328467153284672,159,8203,0.0555555555555556,0.019383152505181,2.86617749825297,17,8044,0.7982115215886
"2366",3591,"IP TRS HEART TRANSPLANT READMIT",548,"110888","ENOXAPARIN 30 MG/0.3 ML SC SYRG",1,1,0.00182481751824818,73,1394,1,0.0523672883787661,19.0958904109589,0,1321,0.0460518955900975
"2367",3591,"IP TRS HEART TRANSPLANT READMIT",548,"125813","INSULIN DETEMIR 100 UNIT/ML SC SOLN",1,10,0.0182481751824818,215,3971,0.1,0.0541425333669101,1.84697674418605,9,3756,0.999999999999999
"2368",3591,"IP TRS HEART TRANSPLANT READMIT",548,"126009","MEPERIDINE (PF) 25 MG/ML INJ SYRG",1,2,0.00364963503649635,164,2764,0.5,0.0593342981186686,8.42682926829268,1,2600,0.255540661714246
"2369",3591,"IP TRS HEART TRANSPLANT READMIT",548,"126992","LIDOCAINE (PF) 10 MG/ML (1 %) INJ SOLN",1,38,0.0693430656934307,457,11068,0.0263157894736842,0.0412902059992772,0.637337325809052,37,10611,0.956281570770742
"2370",3591,"IP TRS HEART TRANSPLANT READMIT",548,"198509","ONDANSETRON HCL (PF) 4 MG/2 ML INJ SOLN",2,80,0.145985401459854,705,36939,0.025,0.0190855193697718,1.30989361702128,78,36234,0.999999999999973
"2371",3591,"IP TRS HEART TRANSPLANT READMIT",548,"212945","HEPARIN, PORCINE (PF) 5,000 UNIT/0.5 ML INJ SOLN",1,99,0.180656934306569,452,13480,0.0101010101010101,0.0335311572700297,0.301242513631894,98,13028,0.311247997415857
"2372",3591,"IP TRS HEART TRANSPLANT READMIT",548,"540133","CYCLOSPORINE MODIFIED (GENGRAF) 100 MG PO CAPS",1,2,0.00364963503649635,18,484,0.5,0.0371900826446281,13.4444444444444,1,466,0.123060908374911
"2373",3601,"OPH CATARACT PERIOPERATIVE ORDERS RIGHT EYE",12,"101","ACETAMINOPHEN 325 MG PO TABS",1,9,0.75,981,42092,0.111111111111111,0.0233060914187969,4.76747083474912,8,41111,0.521719524918104
"2374",3603,"IP HEM ACUTE LEUKEMIA",612,"310","ALLOPURINOL 100 MG PO TABS",1,2,0.00326797385620915,47,2267,0.5,0.0207322452580503,24.1170212765957,1,2220,0.0244471119328747
"2375",3603,"IP HEM ACUTE LEUKEMIA",612,"10747","NORETHINDRONE ACETATE 5 MG PO TABS",1,12,0.0196078431372549,48,702,0.0833333333333333,0.0683760683760684,1.21875,11,654,0.999999999999957
"2376",3603,"IP HEM ACUTE LEUKEMIA",612,"27838","SODIUM CHLORIDE 0.9 % 0.9 % IV SOLP",3,56,0.0915032679738562,692,19620,0.0535714285714286,0.0352701325178389,1.51888934764657,53,18928,0.705138476617487
"2377",3622,"IP TRS HEART TRANSPLANT TRANSFER FROM ICU",517,"3074","FERROUS SULFATE 325 MG (65 MG IRON) PO TABS",6,180,0.34816247582205,97,6557,0.0333333333333333,0.0147933506176605,2.253264604811,174,6460,0.0906264715081994
"2378",3622,"IP TRS HEART TRANSPLANT TRANSFER FROM ICU",517,"11111","PRAVASTATIN 20 MG PO TABS",3,162,0.313346228239845,38,2869,0.0185185185185185,0.0132450331125828,1.39814814814815,159,2831,0.829168817657079
"2379",3622,"IP TRS HEART TRANSPLANT TRANSFER FROM ICU",517,"14113","ASPIRIN 81 MG PO TBEC",4,131,0.253384912959381,391,18448,0.0305343511450382,0.0211947094535993,1.4406591046641,127,18057,0.663914527476671
"2380",3622,"IP TRS HEART TRANSPLANT TRANSFER FROM ICU",517,"19483","CALCIUM CARBONATE-VITAMIN D3 500 MG(1,250MG) -200 UNIT PO TABS",3,177,0.342359767891683,27,2802,0.0169491525423729,0.00963597430406852,1.75894538606403,174,2775,0.577555935886173
"2381",3622,"IP TRS HEART TRANSPLANT TRANSFER FROM ICU",517,"208479","MAGNESIUM OXIDE-MG AA CHELATE 133 MG PO TABS",7,176,0.340425531914894,69,3355,0.0397727272727273,0.0205663189269747,1.9338768115942,169,3286,0.148449423944246
"2382",3622,"IP TRS HEART TRANSPLANT TRANSFER FROM ICU",517,"520082","PAMIDRONATE IVPB",1,95,0.183752417794971,10,243,0.0105263157894737,0.0411522633744856,0.255789473684211,94,233,0.277727216514622
"2383",3622,"IP TRS HEART TRANSPLANT TRANSFER FROM ICU",517,"540492","SHC TRANSPLANT BEDSIDE MEDS HELP ORDER",35,167,0.323017408123791,3,27,0.209580838323353,0.111111111111111,1.88622754491018,132,24,0.34987205137997
"2384",3622,"IP TRS HEART TRANSPLANT TRANSFER FROM ICU",517,"540597","THERAPEUTIC MULTIVITAMIN (GENERIC) PO TABS",5,174,0.336557059961315,106,7394,0.028735632183908,0.0143359480659995,2.00444589026242,169,7288,0.213954394301614
"2385",3661,"IP CTS TAVR CV POSTOP",258,"101","ACETAMINOPHEN 325 MG PO TABS",2,103,0.39922480620155,981,42092,0.0194174757281553,0.0233060914187969,0.833150242965866,101,41111,0.999999999999974
"2386",3661,"IP CTS TAVR CV POSTOP",258,"1080","BISACODYL 10 MG PR SUPP",1,9,0.0348837209302326,344,22442,0.111111111111111,0.0153284021031994,7.24870801033592,8,22098,0.326910264620884
"2387",3661,"IP CTS TAVR CV POSTOP",258,"14113","ASPIRIN 81 MG PO TBEC",2,35,0.135658914728682,391,18448,0.0571428571428571,0.0211947094535993,2.69609061015711,33,18057,0.37538759383229
"2388",3661,"IP CTS TAVR CV POSTOP",258,"38285","ALUM-MAG HYDROXIDE-SIMETH 200-200-20 MG/5 ML PO SUSP",3,89,0.344961240310078,71,5546,0.0337078651685393,0.0128020194734944,2.63301155246083,86,5475,0.211501635639844
"2389",3661,"IP CTS TAVR CV POSTOP",258,"124216","VANCOMYCIN IN D5W 1 GRAM/200 ML IV PGBK",2,14,0.0542635658914729,1951,16917,0.142857142857143,0.115327776792576,1.23870542578897,12,14966,0.999999999999967
"2390",3661,"IP CTS TAVR CV POSTOP",258,"198509","ONDANSETRON HCL (PF) 4 MG/2 ML INJ SOLN",1,105,0.406976744186047,705,36939,0.00952380952380952,0.0190855193697718,0.499007092198582,104,36234,0.720203004610847
"2391",3661,"IP CTS TAVR CV POSTOP",258,"236263","CEFAZOLIN IN DEXTROSE (ISO-OS) 2 GRAM/100 ML IV PGBK",3,98,0.37984496124031,111,2584,0.0306122448979592,0.0429566563467492,0.712630998345284,95,2473,0.734222144791123
"2392",3661,"IP CTS TAVR CV POSTOP",258,"540301","POTASSIUM CHLORIDE ORAL SCALE",1,104,0.403100775193798,105,3653,0.00961538461538462,0.0287434984943882,0.33452380952381,103,3548,0.389036053917337
"2393",3724,"IP TRS PRE TRANSPLANT CARE",71,"25121","OCTREOTIDE ACETATE 50 MCG/ML INJ SOLN",1,1,0.0140845070422535,16,150,1,0.106666666666667,9.375,0,134,0.218785413317582
"2394",3724,"IP TRS PRE TRANSPLANT CARE",71,"541085","CEFTRIAXONE 1 GRAM/50 ML MINI-BAG PLUS",2,4,0.0563380281690141,411,7130,0.5,0.0576437587657784,8.67396593673966,2,6719,0.00659877935716515
"2395",3732,"RETIRED ENT PERIOPERATIVE ORDERS",120,"25365","CEFAZOLIN IN DEXTROSE (ISO-OS) 1 GRAM/50 ML IV PGBK",1,5,0.0416666666666667,258,5335,0.2,0.0483598875351453,4.13565891472868,4,5077,0.591760756758056
"2396",3732,"RETIRED ENT PERIOPERATIVE ORDERS",120,"212945","HEPARIN, PORCINE (PF) 5,000 UNIT/0.5 ML INJ SOLN",1,2,0.0166666666666667,452,13480,0.5,0.0335311572700297,14.9115044247788,1,13028,0.0894223689889605
"2397",3732,"RETIRED ENT PERIOPERATIVE ORDERS",120,"520064","CEFAZOLIN 2 G IVPB",1,6,0.05,109,2674,0.166666666666667,0.0407629020194465,4.08868501529052,5,2565,0.601179202717766
"2398",3734,"ED TRAUMA MEDICATION",499,"25365","CEFAZOLIN IN DEXTROSE (ISO-OS) 1 GRAM/50 ML IV PGBK",5,24,0.0480961923847695,258,5335,0.208333333333333,0.0483598875351453,4.30797803617571,19,5077,0.00165425194613992
"2399",3734,"ED TRAUMA MEDICATION",499,"125357","DIPHTH,PERTUS(ACELL),TETANUS 2.5-8-5 LF-MCG-LF/0.5ML IM SUSP",2,25,0.0501002004008016,5,120,0.08,0.0416666666666667,1.92,23,115,0.76370117989197
"2400",3734,"ED TRAUMA MEDICATION",499,"198509","ONDANSETRON HCL (PF) 4 MG/2 ML INJ SOLN",3,190,0.380761523046092,705,36939,0.0157894736842105,0.0190855193697718,0.827301231802912,187,36234,0.947826671808323
"2401",3734,"ED TRAUMA MEDICATION",499,"540106","FENTANYL (PF) 50 MCG/ML INJECTION",4,265,0.531062124248497,461,18637,0.0150943396226415,0.0247357407308043,0.610223877542668,261,18176,0.420014962881312
"2402",3734,"ED TRAUMA MEDICATION",499,"541184","DIPHTH,PERTUS(ACELL),TETANUS 2.5-8-5 LF-MCG-LF/0.5ML IM INJ",3,158,0.316633266533066,26,783,0.0189873417721519,0.033205619412516,0.571811100292113,155,757,0.489570195893051
"2403",3743,"IP CAR PERIPHERAL AMIODARONE IV",1203,"4454","LIDOCAINE HCL 20 MG/ML (2 %) INJ SOLN",5,91,0.0756442227763924,97,1404,0.0549450549450549,0.0690883190883191,0.795287187039764,86,1307,0.761091582560623
"2404",3743,"IP CAR PERIPHERAL AMIODARONE IV",1203,"7309","SODIUM BICARBONATE 8.4 % IV SOLN",20,186,0.154613466334165,186,3436,0.10752688172043,0.0541327124563446,1.98635680425483,166,3250,0.00373338261587687
"2405",3743,"IP CAR PERIPHERAL AMIODARONE IV",1203,"81839","LIDOCAINE 4 % TP CREA",7,119,0.0989193682460515,31,996,0.0588235294117647,0.0311244979919679,1.8899430740038,112,965,0.19130957991189
"2406",3743,"IP CAR PERIPHERAL AMIODARONE IV",1203,"530001","AMIODARONE INFUSION PERIPH ADMIN",72,1011,0.840399002493766,7,168,0.0712166172106825,0.0416666666666667,1.70919881305638,939,161,0.210604348461921
"2407",3743,"IP CAR PERIPHERAL AMIODARONE IV",1203,"530200","AMIODARONE PERIPHERAL INFUSION",56,726,0.603491271820449,4,45,0.0771349862258953,0.0888888888888889,0.867768595041322,670,41,0.999999999999999
"2408",3755,"IP PLS FREE FLAP",721,"101","ACETAMINOPHEN 325 MG PO TABS",4,117,0.162274618585298,981,42092,0.0341880341880342,0.0233060914187969,1.46691410299973,113,41111,0.636944191783983
"2409",3755,"IP PLS FREE FLAP",721,"681","ASPIRIN 325 MG PO TABS",2,107,0.148404993065187,303,7114,0.0186915887850467,0.0425920719707619,0.438851361771691,105,6811,0.328112669478814
"2410",3755,"IP PLS FREE FLAP",721,"693","ASPIRIN 300 MG PR SUPP",1,90,0.124826629680999,70,1872,0.0111111111111111,0.0373931623931624,0.297142857142857,89,1802,0.310021574213686
"2411",3755,"IP PLS FREE FLAP",721,"1080","BISACODYL 10 MG PR SUPP",5,140,0.194174757281553,344,22442,0.0357142857142857,0.0153284021031994,2.32994186046512,135,22098,0.108334310531256
"2412",3755,"IP PLS FREE FLAP",721,"2509","DIPHENHYDRAMINE HCL 25 MG PO CAPS",1,110,0.152565880721221,356,12049,0.00909090909090909,0.0295460204166321,0.307686414708887,109,11693,0.32640737170282
"2413",3755,"IP PLS FREE FLAP",721,"2566","DOCUSATE SODIUM 100 MG PO CAPS",3,120,0.166435506241331,542,37509,0.025,0.0144498653656456,1.73011992619926,117,36967,0.559795294602241
"2414",3755,"IP PLS FREE FLAP",721,"14863","POTASSIUM CHLORID-D5-0.45%NACL 20 MEQ/L IV SOLP",2,129,0.178918169209431,314,8762,0.0155038759689922,0.035836566993837,0.432627265096529,127,8448,0.317927888492
"2415",3755,"IP PLS FREE FLAP",721,"25365","CEFAZOLIN IN DEXTROSE (ISO-OS) 1 GRAM/50 ML IV PGBK",1,86,0.119278779472954,258,5335,0.0116279069767442,0.0483598875351453,0.24044528574004,85,5077,0.183680815322227
"2416",3755,"IP PLS FREE FLAP",721,"110888","ENOXAPARIN 30 MG/0.3 ML SC SYRG",1,4,0.00554785020804438,73,1394,0.25,0.0523672883787661,4.77397260273973,3,1321,0.5191411227568
"2417",3755,"IP PLS FREE FLAP",721,"198509","ONDANSETRON HCL (PF) 4 MG/2 ML INJ SOLN",4,149,0.206657420249653,705,36939,0.0268456375838926,0.0190855193697718,1.4065971726403,145,36234,0.696077623915495
"2418",3755,"IP PLS FREE FLAP",721,"212945","HEPARIN, PORCINE (PF) 5,000 UNIT/0.5 ML INJ SOLN",2,30,0.0416088765603329,452,13480,0.0666666666666667,0.0335311572700297,1.9882005899705,28,13028,0.617873639429136
"2419",3755,"IP PLS FREE FLAP",721,"214400","BENZOCAINE-MENTHOL 15-3.6 MG MM LOZG",1,113,0.156726768377254,71,6103,0.00884955752212389,0.0116336228084549,0.760688021936931,112,6032,0.999999999999997
"2420",3755,"IP PLS FREE FLAP",721,"540142","DIPHENHYDRAMINE 25 MG/50 ML NS IVPB (CANCER CENTER ONLY)",5,15,0.0208044382801664,95,264,0.333333333333333,0.359848484848485,0.926315789473684,10,169,0.999999999999999
"2421",3755,"IP PLS FREE FLAP",721,"540304","MAGNESIUM SULFATE IV SCALE ",1,23,0.0319001386962552,78,4104,0.0434782608695652,0.0190058479532164,2.2876254180602,22,4026,0.92737739040887
"2422",3756,"IP PLS ICU HEAND AND NECK FREE FLAP",203,"681","ASPIRIN 325 MG PO TABS",2,22,0.108374384236453,303,7114,0.0909090909090909,0.0425920719707619,2.13441344134413,20,6811,0.554622837003834
"2423",3756,"IP PLS ICU HEAND AND NECK FREE FLAP",203,"693","ASPIRIN 300 MG PR SUPP",2,29,0.142857142857143,70,1872,0.0689655172413793,0.0373931623931624,1.84433497536946,27,1802,0.693796073270945
"2424",3756,"IP PLS ICU HEAND AND NECK FREE FLAP",203,"5018","METRONIDAZOLE IN NACL (ISO-OS) 500 MG/100 ML IV PGBK",1,27,0.133004926108374,223,3847,0.037037037037037,0.0579672472056148,0.638930410230859,26,3624,0.95962901316619
"2425",3756,"IP PLS ICU HEAND AND NECK FREE FLAP",203,"9516","CHLORHEXIDINE GLUCONATE 0.12 % MM MWSH",2,19,0.0935960591133005,89,4372,0.105263157894737,0.0203568161024703,5.17090479006505,17,4283,0.0742049906423438
"2426",3756,"IP PLS ICU HEAND AND NECK FREE FLAP",203,"110892","ENOXAPARIN 40 MG/0.4 ML SC SYRG",1,20,0.0985221674876847,499,13896,0.05,0.0359096142774899,1.39238476953908,19,13397,0.999999999999994
"2427",3756,"IP PLS ICU HEAND AND NECK FREE FLAP",203,"212945","HEPARIN, PORCINE (PF) 5,000 UNIT/0.5 ML INJ SOLN",1,23,0.113300492610837,452,13480,0.0434782608695652,0.0335311572700297,1.29665255867641,22,13028,0.999999999999998
"2428",3821,"ED HIP FRACTURE SYMPTOMS",164,"101","ACETAMINOPHEN 325 MG PO TABS",1,5,0.0304878048780488,981,42092,0.2,0.0233060914187969,8.58144750254842,4,41111,0.255989696965087
"2429",3821,"ED HIP FRACTURE SYMPTOMS",164,"102","ACETAMINOPHEN 500 MG PO TABS",2,11,0.0670731707317073,392,15968,0.181818181818182,0.0245490981963928,7.40630797773655,9,15576,0.0168550323143895
"2430",3821,"ED HIP FRACTURE SYMPTOMS",164,"10814","OXYCODONE 5 MG PO TABS",1,4,0.024390243902439,1478,56614,0.25,0.0261066167379094,9.57611637347767,3,55136,0.21501509130241
"2431",3821,"ED HIP FRACTURE SYMPTOMS",164,"540106","FENTANYL (PF) 50 MCG/ML INJECTION",1,9,0.0548780487804878,461,18637,0.111111111111111,0.0247357407308043,4.49192576524464,8,18176,0.552419012168307
"2432",3824,"IP VAS VASCULAR ICU",549,"101","ACETAMINOPHEN 325 MG PO TABS",1,17,0.0309653916211293,981,42092,0.0588235294117647,0.0233060914187969,2.52395514780836,16,41111,0.867803897759476
"2433",3824,"IP VAS VASCULAR ICU",549,"696","ASPIRIN 600 MG PR SUPP",1,1,0.00182149362477231,5,94,1,0.0531914893617021,18.8,0,89,0.0710108722424495
"2434",3824,"IP VAS VASCULAR ICU",549,"4318","LACTATED RINGERS IV SOLP",3,56,0.10200364298725,135,4847,0.0535714285714286,0.0278522797606767,1.9234126984127,53,4712,0.452819409364064
"2435",3824,"IP VAS VASCULAR ICU",549,"5007","METOPROLOL TARTRATE 5 MG/5 ML IV SOLN",1,17,0.0309653916211293,745,12385,0.0588235294117647,0.0601534113847396,0.977891827872088,16,11640,0.999999999999649
"2436",3824,"IP VAS VASCULAR ICU",549,"5373","NALOXONE 0.4 MG/ML INJ SOLN",4,126,0.229508196721311,83,1774,0.0317460317460317,0.0467869222096956,0.678523618282654,122,1691,0.575527397449695
"2437",3824,"IP VAS VASCULAR ICU",549,"5940","OXYCODONE-ACETAMINOPHEN 5-325 MG PO TABS",2,13,0.0236794171220401,218,7862,0.153846153846154,0.0277283134062579,5.54834156669019,11,7644,0.0555044828568314
"2438",3824,"IP VAS VASCULAR ICU",549,"10011","FAMOTIDINE 20 MG PO TABS",1,4,0.00728597449908925,472,16960,0.25,0.0278301886792453,8.98305084745763,3,16488,0.238032036632024
"2439",3824,"IP VAS VASCULAR ICU",549,"11150","PROPOFOL 10 MG/ML IV EMUL",2,10,0.0182149362477231,135,3592,0.2,0.0375835189309577,5.32148148148148,8,3457,0.0637939704387655
"2440",3824,"IP VAS VASCULAR ICU",549,"14863","POTASSIUM CHLORID-D5-0.45%NACL 20 MEQ/L IV SOLP",1,18,0.0327868852459016,314,8762,0.0555555555555556,0.035836566993837,1.55024769992923,17,8448,0.999999999999547
"2441",3824,"IP VAS VASCULAR ICU",549,"16426","NS WITH POTASSIUM CHLORIDE 20 MEQ/L IV SOLP",2,9,0.0163934426229508,118,4415,0.222222222222222,0.026727066817667,8.31450094161958,7,4297,0.00989079003251237
"2442",3824,"IP VAS VASCULAR ICU",549,"25365","CEFAZOLIN IN DEXTROSE (ISO-OS) 1 GRAM/50 ML IV PGBK",2,21,0.0382513661202186,258,5335,0.0952380952380952,0.0483598875351453,1.96936138796604,19,5077,0.624888148633429
"2443",3824,"IP VAS VASCULAR ICU",549,"82384","PANTOPRAZOLE 40 MG IV SOLR",1,43,0.0783242258652095,688,12925,0.0232558139534884,0.0532301740812379,0.436891563007031,42,12237,0.593095583034376
"2444",3824,"IP VAS VASCULAR ICU",549,"112520","SODIUM CHLORIDE 0.9 % 0.9 % INJ SYRG",2,72,0.131147540983607,11,154,0.0277777777777778,0.0714285714285714,0.388888888888889,70,143,0.314145847080304
"2445",3824,"IP VAS VASCULAR ICU",549,"115141","ESMOLOL IN NACL (ISO-OSM) 2,000 MG/100 ML IV SOLP",3,8,0.0145719489981785,1,114,0.375,0.0087719298245614,42.75,5,113,4.30807177337261e-06
"2446",3824,"IP VAS VASCULAR ICU",549,"126992","LIDOCAINE (PF) 10 MG/ML (1 %) INJ SOLN",1,46,0.0837887067395264,457,11068,0.0217391304347826,0.0412902059992772,0.526496051755304,45,10611,0.768705653930637
"2447",3824,"IP VAS VASCULAR ICU",549,"198509","ONDANSETRON HCL (PF) 4 MG/2 ML INJ SOLN",1,85,0.154826958105647,705,36939,0.0117647058823529,0.0190855193697718,0.616420525657071,84,36234,0.923564261846866
"2448",3824,"IP VAS VASCULAR ICU",549,"202606","FAMOTIDINE (PF) 20 MG/2 ML IV SOLN",5,26,0.0473588342440801,288,4280,0.192307692307692,0.0672897196261682,2.85790598290598,21,3992,0.0329087744073592
"2449",3824,"IP VAS VASCULAR ICU",549,"207694","NOREPINEPHRINE BITARTRATE-NACL 4 MG/250 ML (16 MCG/ML) IV SOLN",2,8,0.0145719489981785,56,1641,0.25,0.0341255332114564,7.32589285714286,6,1585,0.0190526848165772
"2450",3824,"IP VAS VASCULAR ICU",549,"211084","CALCIUM GLUCONATE IN 0.9% NACL 1 GRAM/50 ML IV SOLN",2,54,0.0983606557377049,326,12268,0.037037037037037,0.0265731985653733,1.3937741422404,52,11942,0.957720587781296
"2451",3824,"IP VAS VASCULAR ICU",549,"212629","ACETAMINOPHEN 1,000 MG/100 ML (10 MG/ML) IV SOLN",5,59,0.107468123861566,510,18335,0.0847457627118644,0.0278156531224434,3.04669325357262,54,17825,0.0243682329488737
"2452",3824,"IP VAS VASCULAR ICU",549,"212945","HEPARIN, PORCINE (PF) 5,000 UNIT/0.5 ML INJ SOLN",3,20,0.0364298724954463,452,13480,0.15,0.0335311572700297,4.47345132743363,17,13028,0.023567798559628
"2453",3824,"IP VAS VASCULAR ICU",549,"221562","CALCIUM CHLORIDE 1 GRAM (13.6 MEQ)/50 ML NS IVPB",1,24,0.0437158469945355,156,2315,0.0416666666666667,0.0673866090712743,0.61832264957265,23,2159,0.927517101050204
"2454",3824,"IP VAS VASCULAR ICU",549,"229762","DEXMEDETOMIDINE IN 0.9 % NACL 400 MCG/100 ML (4 MCG/ML) IV SOLN",1,16,0.029143897996357,291,6612,0.0625,0.044010889292196,1.42010309278351,15,6321,0.99999999999999
"2455",3824,"IP VAS VASCULAR ICU",549,"236263","CEFAZOLIN IN DEXTROSE (ISO-OS) 2 GRAM/100 ML IV PGBK",2,18,0.0327868852459016,111,2584,0.111111111111111,0.0429566563467492,2.58658658658659,16,2473,0.404537733261115
"2456",3824,"IP VAS VASCULAR ICU",549,"500027","D5W WITH SODIUM BICARBONATE 154 MEQ/L  IV INFUSION FOR CONTRAST STUDY",1,5,0.00910746812386157,54,1287,0.2,0.041958041958042,4.76666666666667,4,1233,0.52390959410828
"2457",3824,"IP VAS VASCULAR ICU",549,"530008","NITROPRUSSIDE IV INFUSION",1,2,0.00364298724954463,79,2082,0.5,0.0379442843419789,13.1772151898734,1,2003,0.119147561001289
"2458",3824,"IP VAS VASCULAR ICU",549,"530010","NICARDIPINE IV INFUSION",2,5,0.00910746812386157,257,676,0.4,0.380177514792899,1.05214007782101,3,419,0.999999999999979
"2459",3824,"IP VAS VASCULAR ICU",549,"530011","NOREPINEPHRINE IV INFUSION",1,5,0.00910746812386157,92,2909,0.2,0.0316259883121348,6.32391304347826,4,2817,0.386010407234897
"2460",3824,"IP VAS VASCULAR ICU",549,"540106","FENTANYL (PF) 50 MCG/ML INJECTION",2,47,0.0856102003642987,461,18637,0.0425531914893617,0.0247357407308043,1.72031199520007,45,18176,0.752744074908311
"2461",3824,"IP VAS VASCULAR ICU",549,"540302","POTASSIUM CHLORIDE IV SCALE",3,74,0.134790528233151,150,4660,0.0405405405405405,0.0321888412017167,1.25945945945946,71,4510,0.942764708260785
"2462",3824,"IP VAS VASCULAR ICU",549,"540304","MAGNESIUM SULFATE IV SCALE ",3,77,0.140255009107468,78,4104,0.038961038961039,0.0190058479532164,2.04995004995005,74,4026,0.40012042076953
"2463",3881,"IP MED CYSTIC FIBROSIS INCOMPLETE/PARTIAL DIOS",269,"500011","POTASSIUM PHOSPHATE IVPB",2,63,0.234200743494424,574,9157,0.0317460317460317,0.0626842852462597,0.506443227697583,61,8583,0.453243189572797
"2464",3881,"IP MED CYSTIC FIBROSIS INCOMPLETE/PARTIAL DIOS",269,"540302","POTASSIUM CHLORIDE IV SCALE",1,41,0.152416356877323,150,4660,0.024390243902439,0.0321888412017167,0.757723577235772,40,4510,0.999999999999999
"2465",3881,"IP MED CYSTIC FIBROSIS INCOMPLETE/PARTIAL DIOS",269,"540304","MAGNESIUM SULFATE IV SCALE ",1,56,0.20817843866171,78,4104,0.0178571428571429,0.0190058479532164,0.93956043956044,55,4026,0.999999999999989
"2466",3881,"IP MED CYSTIC FIBROSIS INCOMPLETE/PARTIAL DIOS",269,"540699","CF ENEMA SOLUTION",3,96,0.356877323420074,8,509,0.03125,0.0157170923379175,1.98828125,93,501,0.529743623818338
"2467",3885,"IP MED CYSTIC FIBROSIS COMPLETE DIOS",101,"126992","LIDOCAINE (PF) 10 MG/ML (1 %) INJ SOLN",1,12,0.118811881188119,457,11068,0.0833333333333333,0.0412902059992772,2.018234865062,11,10611,0.995402739330949
"2468",3885,"IP MED CYSTIC FIBROSIS COMPLETE DIOS",101,"500011","POTASSIUM PHOSPHATE IVPB",1,22,0.217821782178218,574,9157,0.0454545454545455,0.0626842852462597,0.725134621476085,21,8583,0.999999999999613
"2469",3885,"IP MED CYSTIC FIBROSIS COMPLETE DIOS",101,"540302","POTASSIUM CHLORIDE IV SCALE",1,19,0.188118811881188,150,4660,0.0526315789473684,0.0321888412017167,1.63508771929825,18,4510,0.999999999999997
"2470",3885,"IP MED CYSTIC FIBROSIS COMPLETE DIOS",101,"540304","MAGNESIUM SULFATE IV SCALE ",1,17,0.168316831683168,78,4104,0.0588235294117647,0.0190058479532164,3.09502262443439,16,4026,0.757632603093063
"2471",3885,"IP MED CYSTIC FIBROSIS COMPLETE DIOS",101,"540699","CF ENEMA SOLUTION",4,19,0.188118811881188,8,509,0.210526315789474,0.0157170923379175,13.3947368421053,15,501,1.50631725845031e-06
"2472",3886,"ED PSYCH HOLDING",62,"101","ACETAMINOPHEN 325 MG PO TABS",2,19,0.306451612903226,981,42092,0.105263157894737,0.0233060914187969,4.51655131713075,17,41111,0.10836523363797
"2473",3886,"ED PSYCH HOLDING",62,"94176","ONDANSETRON 4 MG PO TBDL",1,11,0.17741935483871,153,4277,0.0909090909090909,0.0357727379003975,2.54129530600119,10,4124,0.86480082417744
"2474",3886,"ED PSYCH HOLDING",62,"95933","OLANZAPINE 5 MG PO TBDL",1,14,0.225806451612903,152,3857,0.0714285714285714,0.0394088669950739,1.8125,13,3705,0.999999999999998
"2475",3938,"IP PHARM PENICILLIN SKIN TEST",86,"250","ALBUTEROL SULFATE 2.5 MG /3 ML (0.083 %) INH NEBU",1,26,0.302325581395349,106,3939,0.0384615384615385,0.0269103833460269,1.42924528301887,25,3833,0.999999999999999
"2476",3938,"IP PHARM PENICILLIN SKIN TEST",86,"681","ASPIRIN 325 MG PO TABS",1,16,0.186046511627907,303,7114,0.0625,0.0425920719707619,1.46740924092409,15,6811,0.999999999999998
"2477",3938,"IP PHARM PENICILLIN SKIN TEST",86,"2508","DIPHENHYDRAMINE HCL 50 MG/ML INJ SOLN",1,36,0.418604651162791,399,16019,0.0277777777777778,0.0249079218428117,1.11521860206071,35,15620,0.999999999999436
"2478",3938,"IP PHARM PENICILLIN SKIN TEST",86,"3774","HYDROXYZINE HCL 25 MG PO TABS",2,22,0.255813953488372,133,4979,0.0909090909090909,0.0267121912030528,3.40328092959672,20,4846,0.232229843493797
"2479",3938,"IP PHARM PENICILLIN SKIN TEST",86,"4572","LORAZEPAM 0.5 MG PO TABS",1,12,0.13953488372093,349,13238,0.0833333333333333,0.0263634990179785,3.16093600764088,11,12889,0.741701195801289
"2480",3938,"IP PHARM PENICILLIN SKIN TEST",86,"6496","PREDNISONE 20 MG PO TABS",1,18,0.209302325581395,276,7517,0.0555555555555556,0.0367167753092989,1.51308373590982,17,7241,0.999999999999599
"2481",3938,"IP PHARM PENICILLIN SKIN TEST",86,"7319","SODIUM CHLORIDE 0.9 % 0.9 % INJ SOLN",1,34,0.395348837209302,59,937,0.0294117647058824,0.0629669156883671,0.467098703888335,33,878,0.66304068465386
"2482",3938,"IP PHARM PENICILLIN SKIN TEST",86,"10467","LORAZEPAM 2 MG/ML INJ SOLN",1,17,0.197674418604651,749,20621,0.0588235294117647,0.0363221958197954,1.61949265687583,16,19872,0.999999999999946
"2483",3938,"IP PHARM PENICILLIN SKIN TEST",86,"40196","ALBUTEROL SULFATE 90 MCG/ACTUATION INH HFAA",1,19,0.22093023255814,110,6310,0.0526315789473684,0.01743264659271,3.01913875598086,18,6200,0.770356216441304
"2484",3938,"IP PHARM PENICILLIN SKIN TEST",86,"90488","BENZYLPENICILLOYL POLYLYSINE 0.25 ML ID SOLN",2,36,0.418604651162791,1,4,0.0555555555555556,0.25,0.222222222222222,34,3,0.689009104052038
"2485",3938,"IP PHARM PENICILLIN SKIN TEST",86,"91619","MONTELUKAST 10 MG PO TABS",1,19,0.22093023255814,23,2145,0.0526315789473684,0.0107226107226107,4.90846681922197,18,2122,0.524449055752342
"2486",3938,"IP PHARM PENICILLIN SKIN TEST",86,"202606","FAMOTIDINE (PF) 20 MG/2 ML IV SOLN",2,27,0.313953488372093,288,4280,0.0740740740740741,0.0672897196261682,1.10082304526749,25,3992,0.999999999999998
"2487",3938,"IP PHARM PENICILLIN SKIN TEST",86,"209509","METHYLPREDNISOLONE SOD SUC(PF) 125 MG/2 ML INJ SOLR",1,25,0.290697674418605,275,8000,0.04,0.034375,1.16363636363636,24,7725,0.999999999999998
"2488",3938,"IP PHARM PENICILLIN SKIN TEST",86,"213662","EPINEPHRINE 1 MG/ML (1:1,000) (1ML) INJ SOLN",2,36,0.418604651162791,69,5047,0.0555555555555556,0.0136714880126808,4.06360708534622,34,4978,0.155276031094858
"2489",3960,"IP ICU SEDATION MANAGEMENT FOR MECHANICALLY VENTILATED PATIENTS",386,"11150","PROPOFOL 10 MG/ML IV EMUL",4,52,0.134715025906736,135,3592,0.0769230769230769,0.0375835189309577,2.04672364672365,48,3457,0.268810634619297
"2490",3960,"IP ICU SEDATION MANAGEMENT FOR MECHANICALLY VENTILATED PATIENTS",386,"89065","LIDOCAINE 5 % TP PTMD",1,1,0.00259067357512953,197,10907,1,0.018061795177409,55.3654822335025,0,10710,0.00030677904673701
"2491",3960,"IP ICU SEDATION MANAGEMENT FOR MECHANICALLY VENTILATED PATIENTS",386,"212629","ACETAMINOPHEN 1,000 MG/100 ML (10 MG/ML) IV SOLN",1,7,0.0181347150259067,510,18335,0.142857142857143,0.0278156531224434,5.13585434173669,6,17825,0.483564867012546
"2492",3960,"IP ICU SEDATION MANAGEMENT FOR MECHANICALLY VENTILATED PATIENTS",386,"229762","DEXMEDETOMIDINE IN 0.9 % NACL 400 MCG/100 ML (4 MCG/ML) IV SOLN",2,74,0.191709844559585,291,6612,0.027027027027027,0.044010889292196,0.614098634717191,72,6321,0.671392724161987
"2493",3960,"IP ICU SEDATION MANAGEMENT FOR MECHANICALLY VENTILATED PATIENTS",386,"530025","DEXMEDETOMIDINE IV INFUSION",22,44,0.113989637305699,530,2902,0.5,0.18263266712612,2.7377358490566,22,2372,2.47072505713368e-07
"2494",3960,"IP ICU SEDATION MANAGEMENT FOR MECHANICALLY VENTILATED PATIENTS",386,"530120","HYDROMORPHONE 10 MG IN 100 ML IV INFUSION (SHC)",5,111,0.287564766839378,130,2894,0.045045045045045,0.0449205252246026,1.002772002772,106,2764,0.999999999999939
"2495",3970,"IP RAD INTERVENTIONAL RADIOLOGY POSTOP (WITH ADMISSION)",1118,"101","ACETAMINOPHEN 325 MG PO TABS",1,53,0.0474060822898032,981,42092,0.0188679245283019,0.0233060914187969,0.809570519108341,52,41111,0.999999999999175
"2496",3970,"IP RAD INTERVENTIONAL RADIOLOGY POSTOP (WITH ADMISSION)",1118,"5002","METOCLOPRAMIDE HCL 5 MG/ML INJ SOLN",1,10,0.00894454382826476,346,10128,0.1,0.0341627172195893,2.9271676300578,9,9782,0.78372849785235
"2497",3970,"IP RAD INTERVENTIONAL RADIOLOGY POSTOP (WITH ADMISSION)",1118,"10814","OXYCODONE 5 MG PO TABS",10,154,0.137745974955277,1478,56614,0.0649350649350649,0.0261066167379094,2.48730295415004,144,55136,0.00579157629032886
"2498",3970,"IP RAD INTERVENTIONAL RADIOLOGY POSTOP (WITH ADMISSION)",1118,"22472","KETOROLAC 15 MG/ML INJ SOLN",1,17,0.0152057245080501,215,5031,0.0588235294117647,0.0427350427350427,1.37647058823529,16,4816,0.999999999999666
"2499",3970,"IP RAD INTERVENTIONAL RADIOLOGY POSTOP (WITH ADMISSION)",1118,"27838","SODIUM CHLORIDE 0.9 % 0.9 % IV SOLP",1,72,0.0644007155635063,692,19620,0.0138888888888889,0.0352701325178389,0.39378612716763,71,18928,0.507703214577724
"2500",3970,"IP RAD INTERVENTIONAL RADIOLOGY POSTOP (WITH ADMISSION)",1118,"96559","PIPERACILLIN-TAZOBACTAM-DEXTRS 3.375 GRAM/50 ML IV PGBK",1,3,0.00268336314847943,1067,10067,0.333333333333333,0.105989867885169,3.14495470165573,2,9000,0.733113684460442
"2501",3970,"IP RAD INTERVENTIONAL RADIOLOGY POSTOP (WITH ADMISSION)",1118,"110872","HYDROMORPHONE 2 MG/ML INJ SYRG",2,29,0.0259391771019678,738,23934,0.0689655172413793,0.0308347956881424,2.23661340061676,27,23196,0.516195656370201
"2502",3970,"IP RAD INTERVENTIONAL RADIOLOGY POSTOP (WITH ADMISSION)",1118,"112586","HYDROMORPHONE 1 MG/ML INJ SYRG",1,32,0.0286225402504472,1219,33427,0.03125,0.036467526251234,0.856926784249385,31,32208,0.999999999998817
"2503",3970,"IP RAD INTERVENTIONAL RADIOLOGY POSTOP (WITH ADMISSION)",1118,"198509","ONDANSETRON HCL (PF) 4 MG/2 ML INJ SOLN",4,218,0.194991055456172,705,36939,0.018348623853211,0.0190855193697718,0.961389810657818,214,36234,0.999999999999996
"2504",3970,"IP RAD INTERVENTIONAL RADIOLOGY POSTOP (WITH ADMISSION)",1118,"540102","NS IV BOLUS",1,5,0.00447227191413238,2225,80957,0.2,0.0274837259285794,7.27703370786517,4,78732,0.32143108681697
"2505",3970,"IP RAD INTERVENTIONAL RADIOLOGY POSTOP (WITH ADMISSION)",1118,"541271","PIPERACILLIN-TAZOBACTAM 3.375 GRAM/50 ML IVPB EXTENDED INFUSION",1,4,0.0035778175313059,466,8270,0.25,0.0563482466747279,4.43669527896996,3,7804,0.552308510520013
"2506",3972,"IP TRS LUNG, HEART-LUNG TRANSPLANT ",172,"94670","TACROLIMUS 1 MG PO CAPS",1,14,0.0813953488372093,322,9479,0.0714285714285714,0.0339698280409326,2.10270629991127,13,9157,0.972168357343368
"2507",3974,"IP GEN SEPSIS COMPREHENSIVE",1072,"27838","SODIUM CHLORIDE 0.9 % 0.9 % IV SOLP",1,7,0.00652985074626866,692,19620,0.142857142857143,0.0352701325178389,4.05037159372419,6,18928,0.604531998684468
"2508",3974,"IP GEN SEPSIS COMPREHENSIVE",1072,"81505","CIPROFLOXACIN IN D5W 400 MG/200 ML IV PGBK",2,4,0.00373134328358209,242,3682,0.5,0.0657251493753395,7.60743801652893,2,3440,0.0129391816449724
"2509",3974,"IP GEN SEPSIS COMPREHENSIVE",1072,"115288","LEVOFLOXACIN IN D5W 750 MG/150 ML IV PGBK",1,5,0.00466417910447761,208,3699,0.2,0.0562314138956475,3.55673076923077,4,3491,0.672618631294719
"2510",3974,"IP GEN SEPSIS COMPREHENSIVE",1072,"520046","VANCOMYCIN IVPB (CUSTOM DOSE)",8,58,0.0541044776119403,1808,23328,0.137931034482759,0.0775034293552812,1.77967653341471,50,21520,0.141068529299521
"2511",3974,"IP GEN SEPSIS COMPREHENSIVE",1072,"540102","NS IV BOLUS",1,46,0.042910447761194,2225,80957,0.0217391304347826,0.0274837259285794,0.790981924767953,45,78732,0.999999999999518
"2512",3974,"IP GEN SEPSIS COMPREHENSIVE",1072,"541020","VANCOMYCIN ED ORDER ",6,33,0.0307835820895522,213,1807,0.181818181818182,0.117874930824571,1.54246692274861,27,1594,0.393704284281002
"2513",3974,"IP GEN SEPSIS COMPREHENSIVE",1072,"541061","VANCOMYCIN PER PHARMACY PROTOCOL",1,40,0.0373134328358209,239,5475,0.025,0.0436529680365297,0.572698744769874,39,5236,0.851482690206986
"2514",3974,"IP GEN SEPSIS COMPREHENSIVE",1072,"541082","PIPERACILLIN-TAZOBACTAM 4.5 GRAM/100 ML MINI-BAG PLUS EXTENDED INF",1,10,0.00932835820895522,6,49,0.1,0.122448979591837,0.816666666666667,9,43,1
"2515",3974,"IP GEN SEPSIS COMPREHENSIVE",1072,"541084","CEFEPIME 2 GRAM/100 ML MINI-BAG PLUS",1,7,0.00652985074626866,277,3459,0.142857142857143,0.0800809482509396,1.78390923156266,6,3182,0.999999999999988
"2516",3974,"IP GEN SEPSIS COMPREHENSIVE",1072,"541085","CEFTRIAXONE 1 GRAM/50 ML MINI-BAG PLUS",1,19,0.0177238805970149,411,7130,0.0526315789473684,0.0576437587657784,0.913049045972596,18,6719,0.999999999999998
"2517",3974,"IP GEN SEPSIS COMPREHENSIVE",1072,"541086","CEFTRIAXONE 2 GRAM/50 ML MINI-BAG PLUS",1,2,0.00186567164179104,174,2732,0.5,0.0636896046852123,7.85057471264368,1,2558,0.282372255725699
"2518",3974,"IP GEN SEPSIS COMPREHENSIVE",1072,"541273","PIPERACILLIN-TAZOBACTAM 4.5 GRAM/100 ML IVPB EXTENDED INFUSION",12,64,0.0597014925373134,148,1260,0.1875,0.117460317460317,1.59628378378378,52,1112,0.138761575826802
"2519",3974,"IP GEN SEPSIS COMPREHENSIVE",1072,"541441","NS IV BOLUS - 1000 ML",1,33,0.0307835820895522,95,3670,0.0303030303030303,0.0258855585831063,1.17065390749601,32,3575,0.999999999999997
"2520",3974,"IP GEN SEPSIS COMPREHENSIVE",1072,"541442","NS IV BOLUS - 2000 ML",1,11,0.0102611940298507,5,120,0.0909090909090909,0.0416666666666667,2.18181818181818,10,115,0.999999999999992
"2521",3974,"IP GEN SEPSIS COMPREHENSIVE",1072,"541544","CEFEPIME 2 G/100 ML EXTENDED INFUSION MINI-BAG PLUS",4,12,0.0111940298507463,60,934,0.333333333333333,0.0642398286937901,5.18888888888889,8,874,0.00187345125100521
"2522",3974,"IP GEN SEPSIS COMPREHENSIVE",1072,"541547","MEROPENEM 1 G/100 ML EXTENDED INFUSION MINI-BAG PLUS",2,10,0.00932835820895522,71,1342,0.2,0.0529061102831595,3.78028169014085,8,1271,0.177558375243284
"2523",4001,"RETIRED IP NSR STROKE: SUBARACHNOID HEMORRHAGE ",91,"81934","NIMODIPINE 30 MG PO CAPS",1,18,0.197802197802198,23,372,0.0555555555555556,0.0618279569892473,0.898550724637681,17,349,0.999999999999999
"2524",4001,"RETIRED IP NSR STROKE: SUBARACHNOID HEMORRHAGE ",91,"530010","NICARDIPINE IV INFUSION",3,3,0.032967032967033,257,676,1,0.380177514792899,2.63035019455253,0,419,0.107732010681911
"2525",4002,"IP NSR ICU STROKE: SUBARACHANOID HEMORRHAGE ",9,"530010","NICARDIPINE IV INFUSION",1,1,0.111111111111111,257,676,1,0.380177514792899,2.63035019455253,0,419,0.806441615303317
"2526",4004,"IP TRS KIDNEY/PANCREAS INDUCTION/REJECTION MEDICATION",126,"101","ACETAMINOPHEN 325 MG PO TABS",2,89,0.706349206349206,981,42092,0.0224719101123595,0.0233060914187969,0.964207584556002,87,41111,0.999999999999504
"2527",4004,"IP TRS KIDNEY/PANCREAS INDUCTION/REJECTION MEDICATION",126,"2508","DIPHENHYDRAMINE HCL 50 MG/ML INJ SOLN",3,97,0.76984126984127,399,16019,0.0309278350515464,0.0249079218428117,1.24168669095419,94,15620,0.958119278856827
"2528",4004,"IP TRS KIDNEY/PANCREAS INDUCTION/REJECTION MEDICATION",126,"209508","METHYLPREDNISOLONE SOD SUC(PF) 40 MG/ML INJ SOLR",3,33,0.261904761904762,155,3480,0.0909090909090909,0.0445402298850575,2.04105571847507,30,3325,0.391311223426467
"2529",4004,"IP TRS KIDNEY/PANCREAS INDUCTION/REJECTION MEDICATION",126,"209509","METHYLPREDNISOLONE SOD SUC(PF) 125 MG/2 ML INJ SOLR",6,30,0.238095238095238,275,8000,0.2,0.034375,5.81818181818182,24,7725,9.43837559730567e-06
"2530",4004,"IP TRS KIDNEY/PANCREAS INDUCTION/REJECTION MEDICATION",126,"212610","IMMUNE GLOBULIN(HUM),CAPR(IGG) 10 GRAM/100 ML (10 %) INJ SOLN",1,20,0.158730158730159,73,1504,0.05,0.0485372340425532,1.03013698630137,19,1431,0.999999999999995
"2531",4004,"IP TRS KIDNEY/PANCREAS INDUCTION/REJECTION MEDICATION",126,"520074","ANTITHYMOCYTE GLOBULIN RABBIT IVPB",1,66,0.523809523809524,75,1781,0.0151515151515152,0.0421111734980348,0.35979797979798,65,1706,0.442943805864892
"2532",4012,"ED POST-INTUBATION",88,"10607","MIDAZOLAM 1 MG/ML INJ SOLN",2,10,0.113636363636364,155,5616,0.2,0.0275997150997151,7.24645161290323,8,5461,0.0189629000753321
"2533",4012,"ED POST-INTUBATION",88,"11150","PROPOFOL 10 MG/ML IV EMUL",3,21,0.238636363636364,135,3592,0.142857142857143,0.0375835189309577,3.8010582010582,18,3457,0.0525336461350647
"2534",4012,"ED POST-INTUBATION",88,"112586","HYDROMORPHONE 1 MG/ML INJ SYRG",2,9,0.102272727272727,1219,33427,0.222222222222222,0.036467526251234,6.09370157688451,7,32208,0.0373566114204867
"2535",4012,"ED POST-INTUBATION",88,"530004","MIDAZOLAM 50 MG IN D5W 100 ML IV INFUSION",1,10,0.113636363636364,65,1105,0.1,0.0588235294117647,1.7,9,1040,0.999999999999986
"2536",4012,"ED POST-INTUBATION",88,"530120","HYDROMORPHONE 10 MG IN 100 ML IV INFUSION (SHC)",1,15,0.170454545454545,130,2894,0.0666666666666667,0.0449205252246026,1.48410256410256,14,2764,0.999999999999992
"2537",4023,"IP NEU STROKE ADMISSION",1147,"101","ACETAMINOPHEN 325 MG PO TABS",2,98,0.0854402789886661,981,42092,0.0204081632653061,0.0233060914187969,0.875657908423308,96,41111,0.999999999999981
"2538",4023,"IP NEU STROKE ADMISSION",1147,"3697","HYDRALAZINE 20 MG/ML INJ SOLN",1,22,0.019180470793374,537,15149,0.0454545454545455,0.0354478843488019,1.28229219570002,21,14612,0.999999999999961
"2539",4023,"IP NEU STROKE ADMISSION",1147,"10372","LABETALOL 5 MG/ML IV SOLN",1,28,0.024411508282476,370,5898,0.0357142857142857,0.0627331298745337,0.569305019305019,27,5528,0.843203048948744
"2540",4023,"IP NEU STROKE ADMISSION",1147,"11349","SENNOSIDES 8.6 MG PO TABS",1,36,0.031386224934612,610,35793,0.0277777777777778,0.0170424384656218,1.62991803278689,35,35183,0.999999999999991
"2541",4023,"IP NEU STROKE ADMISSION",1147,"13654","ASPIRIN 325 MG PO TBEC",5,24,0.020924149956408,16,582,0.208333333333333,0.0274914089347079,7.578125,19,566,2.94673070081973e-05
"2542",4023,"IP NEU STROKE ADMISSION",1147,"14113","ASPIRIN 81 MG PO TBEC",5,169,0.147340889276373,391,18448,0.029585798816568,0.0211947094535993,1.39590490170856,164,18057,0.627814358358413
"2543",4023,"IP NEU STROKE ADMISSION",1147,"110892","ENOXAPARIN 40 MG/0.4 ML SC SYRG",14,260,0.22667829119442,499,13896,0.0538461538461538,0.0359096142774899,1.49949129027285,246,13397,0.171992430971743
"2544",4023,"IP NEU STROKE ADMISSION",1147,"209037","ACETAMINOPHEN 650 MG/20.3 ML PO SOLN",2,97,0.0845684394071491,192,8611,0.0206185567010309,0.0222970618975729,0.924720790378007,95,8419,0.999999999999782
"2545",4023,"IP NEU STROKE ADMISSION",1147,"212945","HEPARIN, PORCINE (PF) 5,000 UNIT/0.5 ML INJ SOLN",1,8,0.00697471665213601,452,13480,0.125,0.0335311572700297,3.72787610619469,7,13028,0.649770163706163
"2546",4028,"PHC RETINA PERIOPERATIVE ORDERS RIGHT EYE",15,"101","ACETAMINOPHEN 325 MG PO TABS",1,5,0.333333333333333,981,42092,0.2,0.0233060914187969,8.58144750254842,4,41111,0.255989696965087
"2547",4028,"PHC RETINA PERIOPERATIVE ORDERS RIGHT EYE",15,"6487","PREDNISOLONE ACETATE 1 % OPHT DRPS",1,6,0.4,25,1088,0.166666666666667,0.0229779411764706,7.25333333333333,5,1063,0.336775064954837
"2548",4028,"PHC RETINA PERIOPERATIVE ORDERS RIGHT EYE",15,"198509","ONDANSETRON HCL (PF) 4 MG/2 ML INJ SOLN",1,6,0.4,705,36939,0.166666666666667,0.0190855193697718,8.73262411347518,5,36234,0.25049882357025
"2549",4030,"PHC RETINA PERIOPERATIVE ORDERS LEFT EYE",18,"6487","PREDNISOLONE ACETATE 1 % OPHT DRPS",1,5,0.277777777777778,25,1088,0.2,0.0229779411764706,8.704,4,1063,0.262341545790685
"2550",4031,"PHC GLAUCOMA PERIOPERATIVE ORDERS LEFT EYE",3,"101","ACETAMINOPHEN 325 MG PO TABS",1,3,1,981,42092,0.333333333333333,0.0233060914187969,14.3024125042474,2,41111,0.100002477677862
"2551",4045,"IP VAD PRE-OP/DAY OF SURGERY",598,"101","ACETAMINOPHEN 325 MG PO TABS",2,113,0.188963210702341,981,42092,0.0176991150442478,0.0233060914187969,0.759420132968887,111,41111,0.934350258042478
"2552",4045,"IP VAD PRE-OP/DAY OF SURGERY",598,"1080","BISACODYL 10 MG PR SUPP",1,4,0.00668896321070234,344,22442,0.25,0.0153284021031994,16.3095930232558,3,22098,0.0746736552710219
"2553",4045,"IP VAD PRE-OP/DAY OF SURGERY",598,"9516","CHLORHEXIDINE GLUCONATE 0.12 % MM MWSH",1,190,0.317725752508361,89,4372,0.00526315789473684,0.0203568161024703,0.258545239503253,189,4283,0.230861016242538
"2554",4045,"IP VAD PRE-OP/DAY OF SURGERY",598,"10050","FLUCONAZOLE IN NACL (ISO-OSM) 400 MG/200 ML IV PGBK",6,184,0.307692307692308,40,1102,0.0326086956521739,0.0362976406533575,0.898369565217391,178,1062,0.972069953788611
"2555",4045,"IP VAD PRE-OP/DAY OF SURGERY",598,"38285","ALUM-MAG HYDROXIDE-SIMETH 200-200-20 MG/5 ML PO SUSP",1,123,0.205685618729097,71,5546,0.00813008130081301,0.0128020194734944,0.635062406962098,122,5475,0.959627970850596
"2556",4045,"IP VAD PRE-OP/DAY OF SURGERY",598,"111940","FOAM BANDAGE 4 X 4 "" TP BNDG",2,36,0.0602006688963211,1,6,0.0555555555555556,0.166666666666667,0.333333333333333,34,5,0.902661513079929
"2557",4045,"IP VAD PRE-OP/DAY OF SURGERY",598,"520046","VANCOMYCIN IVPB (CUSTOM DOSE)",13,188,0.31438127090301,1808,23328,0.0691489361702128,0.0775034293552812,0.892204857842214,175,21520,0.771909941925248
"2558",4045,"IP VAD PRE-OP/DAY OF SURGERY",598,"541084","CEFEPIME 2 GRAM/100 ML MINI-BAG PLUS",1,49,0.0819397993311037,277,3459,0.0204081632653061,0.0800809482509396,0.254844175937523,48,3182,0.20436033533536
"2559",4045,"IP VAD PRE-OP/DAY OF SURGERY",598,"541106","CEFTAZIDIME 1 GRAM/50 ML MINI-BAG PLUS",5,112,0.187290969899666,14,162,0.0446428571428571,0.0864197530864197,0.516581632653061,107,148,0.272920941217379
"2560",4047,"RETIRED ED PRIMARY HEADACHE ORDERSET",21,"540102","NS IV BOLUS",1,3,0.142857142857143,2225,80957,0.333333333333333,0.0274837259285794,12.1283895131086,2,78732,0.140437186609798
"2561",4047,"RETIRED ED PRIMARY HEADACHE ORDERSET",21,"540148","NS FLUSH BAG",1,2,0.0952380952380952,4,133,0.5,0.0300751879699248,16.625,1,129,0.108118213611607
"2562",4085,"NURSING TRIAGE SEPSIS NURSING PROTOCOL",5327,"540102","NS IV BOLUS",57,1385,0.259996245541581,2225,80957,0.0411552346570397,0.0274837259285794,1.49744014927189,1328,78732,0.00278231660795891
"2563",4085,"NURSING TRIAGE SEPSIS NURSING PROTOCOL",5327,"541440","NS IV BOLUS - 500 ML",1,9,0.00168950628871785,189,5436,0.111111111111111,0.0347682119205298,3.1957671957672,8,5247,0.735332023092462
"2564",4085,"NURSING TRIAGE SEPSIS NURSING PROTOCOL",5327,"541441","NS IV BOLUS - 1000 ML",55,871,0.163506664163694,95,3670,0.0631458094144661,0.0258855585831063,2.43942232159043,816,3575,5.76406030314642e-08
"2565",4223,"OR REN CONTINUOUS RENAL REPLACEMENT THERAPY (CRRT)",60,"126580","HEPARIN, PORCINE (PF) 1,000 UNIT/ML INJ SOLN",1,9,0.15,58,653,0.111111111111111,0.0888208269525268,1.25095785440613,8,595,0.999999999999992
"2566",4223,"OR REN CONTINUOUS RENAL REPLACEMENT THERAPY (CRRT)",60,"205894","PRISMASOL SOLUTION (BGK 2/0) (32 MEQ BICARB/L)",3,32,0.533333333333333,4,19,0.09375,0.210526315789474,0.4453125,29,15,0.452726126603559
"2567",4223,"OR REN CONTINUOUS RENAL REPLACEMENT THERAPY (CRRT)",60,"230501","DEXTROSE-SOD CITRATE-CITRIC AC 2.45-2.2 GRAM- 730 MG/100 ML MISC SOLN",1,6,0.1,2,37,0.166666666666667,0.0540540540540541,3.08333333333333,5,35,0.888173199669631
"2568",4223,"OR REN CONTINUOUS RENAL REPLACEMENT THERAPY (CRRT)",60,"500006","SODIUM PHOSPHATE IVPB",4,48,0.8,296,4785,0.0833333333333333,0.0618599791013584,1.34712837837838,44,4489,0.754350025258409
"2569",4223,"OR REN CONTINUOUS RENAL REPLACEMENT THERAPY (CRRT)",60,"500034","CALCIUM CHLORIDE 8 G/1000 ML NS IV INFUSION",8,22,0.366666666666667,9,166,0.363636363636364,0.0542168674698795,6.70707070707071,14,157,1.30275682672201e-05
"2570",4236,"IP GEN DELIRIUM (FOR NON-ICU PATIENTS ONLY)",2122,"1080","BISACODYL 10 MG PR SUPP",1,19,0.00895381715362865,344,22442,0.0526315789473684,0.0153284021031994,3.43359853121175,18,22098,0.697658520502197
"2571",4236,"IP GEN DELIRIUM (FOR NON-ICU PATIENTS ONLY)",2122,"2566","DOCUSATE SODIUM 100 MG PO CAPS",1,17,0.00801131008482564,542,37509,0.0588235294117647,0.0144498653656456,4.0708704145865,16,36967,0.605848366383774
"2572",4236,"IP GEN DELIRIUM (FOR NON-ICU PATIENTS ONLY)",2122,"3584","HALOPERIDOL LACTATE 5 MG/ML INJ SOLN",1,38,0.0179076343072573,513,10794,0.0263157894736842,0.047526403557532,0.553708833487227,37,10281,0.816742388133581
"2573",4236,"IP GEN DELIRIUM (FOR NON-ICU PATIENTS ONLY)",2122,"8085","TRAZODONE 50 MG PO TABS",2,70,0.0329877474081056,334,11344,0.0285714285714286,0.0294428772919605,0.970402053036784,68,11010,0.99999999999962
"2574",4236,"IP GEN DELIRIUM (FOR NON-ICU PATIENTS ONLY)",2122,"11349","SENNOSIDES 8.6 MG PO TABS",2,19,0.00895381715362865,610,35793,0.105263157894737,0.0170424384656218,6.17653149266609,17,35183,0.0374346780043848
"2575",4236,"IP GEN DELIRIUM (FOR NON-ICU PATIENTS ONLY)",2122,"16830","MELATONIN 3 MG PO TABS",10,605,0.285108388312912,456,17087,0.0165289256198347,0.0266869549950255,0.619363491373061,595,16631,0.160282172805896
"2576",4236,"IP GEN DELIRIUM (FOR NON-ICU PATIENTS ONLY)",2122,"25424","POLYETHYLENE GLYCOL 3350 17 GRAM PO PWPK",2,18,0.00848256361922714,712,36910,0.111111111111111,0.0192901652668653,5.75998751560549,16,36198,0.0485718595653844
"2577",4236,"IP GEN DELIRIUM (FOR NON-ICU PATIENTS ONLY)",2122,"77034","QUETIAPINE 25 MG PO TABS",9,106,0.0499528746465598,544,15894,0.0849056603773585,0.0342267522335473,2.48068118756937,97,15350,0.00987560306250189
"2578",4236,"IP GEN DELIRIUM (FOR NON-ICU PATIENTS ONLY)",2122,"9000000","ZZZ IMS TEMPLATE",1,38,0.0179076343072573,1035,28824,0.0263157894736842,0.0359075770191507,0.732875667429443,37,27789,0.999999999999435
"2579",4237,"ED PEDS ACUTE ASTHMA EXACERBATION (18 MO - 18 YEARS)",2,"251","ALBUTEROL SULFATE 5 MG/ML INH NEBU",1,1,0.5,100,358,1,0.279329608938547,3.58,0,258,0.626277508490792
"2580",4259,"ED PEDS FEVER IN PEDIATRIC ONCOLOGY",2,"520045","MEROPENEM CUSTOM IVPB",1,1,0.5,100,1654,1,0.060459492140266,16.54,0,1554,0.0666030171596958
"2581",4259,"ED PEDS FEVER IN PEDIATRIC ONCOLOGY",2,"570051","VANCOMYCIN PEDIATRIC IV INFUSION",1,1,0.5,4,8,1,0.5,2,0,4,1
"2582",4277,"IP ARGATROBAN INFUSION",1006,"221680","ARGATROBAN IN NACL (ISO-OS) 50 MG/50 ML (1 MG/ML) IV SOLN",9,103,0.102385685884692,6,136,0.087378640776699,0.0441176470588235,1.98058252427184,94,130,0.272953389191892
"2583",4277,"IP ARGATROBAN INFUSION",1006,"541261","ARGATROBAN IV INFUSION (LVAD HIGH BLEED RISK)",16,135,0.134194831013916,1,1,0.118518518518519,1,0.118518518518519,119,0,0.255084875767801
"2584",4317,"SHC TXP DIABETES",151,"16027","SHARPS CONTAINER MISC MISC",2,68,0.450331125827815,1,83,0.0294117647058824,0.0120481927710843,2.44117647058824,66,82,0.861349154844946
"2585",4317,"SHC TXP DIABETES",151,"37706","BD INSULIN PEN NEEDLE UF MINI 31 X 3/16 "" MISC NDLE",2,68,0.450331125827815,1,84,0.0294117647058824,0.0119047619047619,2.47058823529412,66,83,0.853090833545455
"2586",4317,"SHC TXP DIABETES",151,"203639","HUMALOG KWIKPEN 100 UNIT/ML SC INPN",4,56,0.370860927152318,11,419,0.0714285714285714,0.0262529832935561,2.72077922077922,52,408,0.158886833207661
"2587",4317,"SHC TXP DIABETES",151,"205788","TRUETEST TEST STRIPS MISC STRP",1,9,0.0596026490066225,2,69,0.111111111111111,0.0289855072463768,3.83333333333333,8,67,0.776774355704329
"2588",4317,"SHC TXP DIABETES",151,"210305","ONETOUCH DELICA LANCETS 33 GAUGE MISC MISC",2,16,0.105960264900662,1,142,0.125,0.00704225352112676,17.75,14,141,0.0208152946810593
"2589",4317,"SHC TXP DIABETES",151,"222403","ONETOUCH VERIO MISC STRP",1,19,0.125827814569536,2,201,0.0526315789473684,0.00995024875621891,5.28947368421053,18,199,0.618085786749939
"2590",4317,"SHC TXP DIABETES",151,"231561","HUMULIN N KWIKPEN 100 UNIT/ML (3 ML) SC INPN",2,26,0.172185430463576,5,191,0.0769230769230769,0.0261780104712042,2.93846153846154,24,186,0.433989164089528
"2591",4319,"INTERVENTIONAL HOME PRE-ANESTHESIA/PRE-OP ORDERS",447,"101","ACETAMINOPHEN 325 MG PO TABS",2,15,0.0335570469798658,981,42092,0.133333333333333,0.0233060914187969,5.72096500169895,13,41111,0.0492420443702524
"2592",4319,"INTERVENTIONAL HOME PRE-ANESTHESIA/PRE-OP ORDERS",447,"102","ACETAMINOPHEN 500 MG PO TABS",1,111,0.248322147651007,392,15968,0.00900900900900901,0.0245490981963928,0.366979224122081,110,15576,0.454331734928635
"2593",4319,"INTERVENTIONAL HOME PRE-ANESTHESIA/PRE-OP ORDERS",447,"18308","GABAPENTIN 300 MG PO CAPS",3,131,0.293064876957494,588,19458,0.0229007633587786,0.0302189330866482,0.757828322168562,128,18870,0.816706007553129
"2594",4319,"INTERVENTIONAL HOME PRE-ANESTHESIA/PRE-OP ORDERS",447,"25365","CEFAZOLIN IN DEXTROSE (ISO-OS) 1 GRAM/50 ML IV PGBK",2,25,0.0559284116331096,258,5335,0.08,0.0483598875351453,1.65426356589147,23,5077,0.788623617631712
"2595",4319,"INTERVENTIONAL HOME PRE-ANESTHESIA/PRE-OP ORDERS",447,"77052","CELECOXIB 200 MG PO CAPS",2,95,0.212527964205817,20,1192,0.0210526315789474,0.0167785234899329,1.25473684210526,93,1172,0.99999999999999
"2596",4319,"INTERVENTIONAL HOME PRE-ANESTHESIA/PRE-OP ORDERS",447,"205597","ALVIMOPAN 12 MG PO CAPS",3,129,0.288590604026846,28,1117,0.0232558139534884,0.0250671441360788,0.927740863787375,126,1089,0.999999999999973
"2597",4319,"INTERVENTIONAL HOME PRE-ANESTHESIA/PRE-OP ORDERS",447,"212945","HEPARIN, PORCINE (PF) 5,000 UNIT/0.5 ML INJ SOLN",8,64,0.143176733780761,452,13480,0.125,0.0335311572700297,3.72787610619469,56,13028,0.000229251772992304
"2598",4319,"INTERVENTIONAL HOME PRE-ANESTHESIA/PRE-OP ORDERS",447,"520064","CEFAZOLIN 2 G IVPB",2,16,0.0357941834451902,109,2674,0.125,0.0407629020194465,3.06651376146789,14,2565,0.289745751459594
"2599",4319,"INTERVENTIONAL HOME PRE-ANESTHESIA/PRE-OP ORDERS",447,"541110","ERTAPENEM 1 GRAM/50 ML MINI-BAG PLUS",5,143,0.319910514541387,72,1340,0.034965034965035,0.0537313432835821,0.650738150738151,138,1268,0.445340125556059
"2600",4330,"IP GEN SEVERE SEPSIS BUNDLE RAPID",243,"540102","NS IV BOLUS",1,28,0.11522633744856,2225,80957,0.0357142857142857,0.0274837259285794,1.29947030497592,27,78732,0.999999999999245
"2601",4330,"IP GEN SEVERE SEPSIS BUNDLE RAPID",243,"541441","NS IV BOLUS - 1000 ML",1,10,0.0411522633744856,95,3670,0.1,0.0258855585831063,3.86315789473684,9,3575,0.634739944926865
"2602",4565,"SHC AMB AI TESTING & TREATMENT",1,"2508","DIPHENHYDRAMINE HCL 50 MG/ML INJ SOLN",1,1,1,399,16019,1,0.0249079218428117,40.1478696741855,0,15620,0.0023300376053999
"2603",4565,"SHC AMB AI TESTING & TREATMENT",1,"2509","DIPHENHYDRAMINE HCL 25 MG PO CAPS",1,1,1,356,12049,1,0.0295460204166321,33.8455056179775,0,11693,0.00553235077773476
"2604",4565,"SHC AMB AI TESTING & TREATMENT",1,"92888","EPINEPHRINE 0.3 MG/0.3 ML (1:1,000) INJ ATIN",1,1,1,10,73,1,0.136986301369863,7.3,0,63,0.320028118179172
"2605",4572,"SHC PAI PRE-OP/MODERATE SEDATION ORDERS",36,"10607","MIDAZOLAM 1 MG/ML INJ SOLN",1,4,0.111111111111111,155,5616,0.25,0.0275997150997151,9.05806451612903,3,5461,0.236299296530011
"2606",4572,"SHC PAI PRE-OP/MODERATE SEDATION ORDERS",36,"540106","FENTANYL (PF) 50 MCG/ML INJECTION",1,15,0.416666666666667,461,18637,0.0666666666666667,0.0247357407308043,2.69515545914678,14,18176,0.830944400791521
"2607",4614,"ED/IP NURSING NG INSERTION PAIN PROTOCOL",370,"4450","LIDOCAINE HCL 4 % TOPICAL SOLN",1,15,0.0405405405405405,52,381,0.0666666666666667,0.136482939632546,0.488461538461538,14,329,0.694748308212545
"2608",4614,"ED/IP NURSING NG INSERTION PAIN PROTOCOL",370,"4455","LIDOCAINE (PF) 40 MG/ML (4 %) INJ SOLN",3,117,0.316216216216216,50,604,0.0256410256410256,0.0827814569536424,0.30974358974359,114,554,0.0483633462764456
"2609",4632,"IP NSR LAMINECTOMY/DISKECTOMY",92,"10814","OXYCODONE 5 MG PO TABS",1,22,0.239130434782609,1478,56614,0.0454545454545455,0.0261066167379094,1.74111206790503,21,55136,0.999999999999992
"2610",4632,"IP NSR LAMINECTOMY/DISKECTOMY",92,"11349","SENNOSIDES 8.6 MG PO TABS",1,25,0.271739130434783,610,35793,0.04,0.0170424384656218,2.34708196721311,24,35183,0.909537480551858
"2611",4654,"IP HNS FREE FLAP ORDERSET",372,"101","ACETAMINOPHEN 325 MG PO TABS",1,6,0.0161290322580645,981,42092,0.166666666666667,0.0233060914187969,7.15120625212368,5,41111,0.330113946258882
"2612",4654,"IP HNS FREE FLAP ORDERSET",372,"680","ASPIRIN 81 MG PO CHEW",1,68,0.182795698924731,357,11203,0.0147058823529412,0.031866464339909,0.461484593837535,67,10846,0.647173988568757
"2613",4654,"IP HNS FREE FLAP ORDERSET",372,"10011","FAMOTIDINE 20 MG PO TABS",1,11,0.0295698924731183,472,16960,0.0909090909090909,0.0278301886792453,3.26656394453005,10,16488,0.72303347734181
"2614",4654,"IP HNS FREE FLAP ORDERSET",372,"10813","OXYCODONE 5 MG/5 ML PO SOLN",1,68,0.182795698924731,328,8370,0.0147058823529412,0.0391875746714456,0.375269010043042,67,8042,0.468937573997431
"2615",4654,"IP HNS FREE FLAP ORDERSET",372,"14863","POTASSIUM CHLORID-D5-0.45%NACL 20 MEQ/L IV SOLP",1,62,0.166666666666667,314,8762,0.0161290322580645,0.035836566993837,0.450071912882679,61,8448,0.624156731904624
"2616",4654,"IP HNS FREE FLAP ORDERSET",372,"25365","CEFAZOLIN IN DEXTROSE (ISO-OS) 1 GRAM/50 ML IV PGBK",1,47,0.126344086021505,258,5335,0.0212765957446809,0.0483598875351453,0.439963714332839,46,5077,0.602040926000093
"2617",4654,"IP HNS FREE FLAP ORDERSET",372,"112586","HYDROMORPHONE 1 MG/ML INJ SYRG",1,30,0.0806451612903226,1219,33427,0.0333333333333333,0.036467526251234,0.914055236532677,29,32208,0.999999999999988
"2618",4654,"IP HNS FREE FLAP ORDERSET",372,"198509","ONDANSETRON HCL (PF) 4 MG/2 ML INJ SOLN",1,82,0.220430107526882,705,36939,0.0121951219512195,0.0190855193697718,0.63897249610794,81,36234,0.958896288341337
"2619",4654,"IP HNS FREE FLAP ORDERSET",372,"202606","FAMOTIDINE (PF) 20 MG/2 ML IV SOLN",1,34,0.0913978494623656,288,4280,0.0294117647058824,0.0672897196261682,0.437091503267974,33,3992,0.592236034907383
"2620",4658,"PRE-ADMISSION/PRE-OP ORDERS CV SURGERY",640,"9516","CHLORHEXIDINE GLUCONATE 0.12 % MM MWSH",9,258,0.403125,89,4372,0.0348837209302326,0.0203568161024703,1.7136137967076,249,4283,0.176145467525591
"2621",4658,"PRE-ADMISSION/PRE-OP ORDERS CV SURGERY",640,"236263","CEFAZOLIN IN DEXTROSE (ISO-OS) 2 GRAM/100 ML IV PGBK",4,263,0.4109375,111,2584,0.0152091254752852,0.0429566563467492,0.354057479532765,259,2473,0.0441043178286998
"2622",4678,"IP NUR SEVERE SEPSIS NURSE PROTOCOL",512,"541440","NS IV BOLUS - 500 ML",4,27,0.052734375,189,5436,0.148148148148148,0.0347682119205298,4.26102292768959,23,5247,0.00779420295506083
"2623",4683,"IP VAD TPA ALTEPLASE LVAD THROMBUS PROTOCOL",19,"541066","HEPARIN INFUSION LVAD HIGH RISK BLEED",1,8,0.421052631578947,1,22,0.125,0.0454545454545455,2.75,7,21,0.999999999999998
"2624",4727,"IP NSR CERVICAL AND LUMBAR FUSIONS",337,"25365","CEFAZOLIN IN DEXTROSE (ISO-OS) 1 GRAM/50 ML IV PGBK",1,17,0.0504451038575668,258,5335,0.0588235294117647,0.0483598875351453,1.21637026903785,16,5077,0.999999999999997
"2625",4727,"IP NSR CERVICAL AND LUMBAR FUSIONS",337,"198509","ONDANSETRON HCL (PF) 4 MG/2 ML INJ SOLN",1,72,0.213649851632047,705,36939,0.0138888888888889,0.0190855193697718,0.727718676122931,71,36234,0.999999999998187
"2626",4766,"IP GEN HOSPICE ADMISSION",109,"3584","HALOPERIDOL LACTATE 5 MG/ML INJ SOLN",1,27,0.247706422018349,513,10794,0.037037037037037,0.047526403557532,0.779293913796838,26,10281,0.999999999999865
"2627",4766,"IP GEN HOSPICE ADMISSION",109,"25424","POLYETHYLENE GLYCOL 3350 17 GRAM PO PWPK",1,5,0.0458715596330275,712,36910,0.2,0.0192901652668653,10.3679775280899,4,36198,0.189859515999083
"2628",4766,"IP GEN HOSPICE ADMISSION",109,"117414","ARTIFICIAL SALIVA (YERBAS-LYT) MM SPRA",1,13,0.119266055045872,38,452,0.0769230769230769,0.084070796460177,0.91497975708502,12,414,0.999999999999979
